imgpath,height,width,area,pothole_area,nonpothole_area
train/images1000_png_jpg.rf.a448eca15f09f5ee0d3044c2df238fbe.jpg,225,290,65250,39803,25447
train/images1000_png_jpg.rf.a52b3253b8579ae91464e7fd2f23b345.jpg,222,301,66822,41166,25656
train/images1000_png_jpg.rf.e58fbd8797bb9027ac62aaeba8667476.jpg,209,317,66253,39794,26459
train/images1001_png_jpg.rf.27bb437cfacf637c1716edfb3e083bf2.jpg,210,300,63000,38570,24430
train/images1001_png_jpg.rf.b0b3fc740ed87d69b3c8d3a5bf4754e1.jpg,185,282,52170,32183,19987
train/images1001_png_jpg.rf.c6612c95d91316719835b6cda2160fd3.jpg,238,332,79016,48336,30680
train/images1003_png_jpg.rf.055b7aa55fde6aa6e0f1db529e4d33d9.jpg,184,274,50416,30465,19951
train/images1003_png_jpg.rf.15a2a3c142f52903098b309c53964022.jpg,175,254,44450,27040,17410
train/images1003_png_jpg.rf.18c84452b62d232f474df6c1f8d630af.jpg,147,226,33222,19887,13335
train/images1005_png_jpg.rf.86c56d193a5dfa4dae23d37ddb492ba1.jpg,64,114,7296,6182,1114
train/images1005_png_jpg.rf.8817322ef32a7951d4545907bb7190d7.jpg,32,110,3520,2525,995
train/images100_png_jpg.rf.31613beeb9d0ca1787b171cf869fad32.jpg,147,186,27342,15986,11356
train/images100_png_jpg.rf.a9d7ede906f2a17578c0bd8b4cfaef8d.jpg,110,180,19800,13491,6309
train/images1010_png_jpg.rf.263bc6a56dda3c747dd96730c4c6cc47.jpg,102,101,10302,7790,2512
train/images1010_png_jpg.rf.9f3356ae59e71ade54e45760b00c0550.jpg,111,110,12210,9014,3196
train/images1016_png_jpg.rf.16e8a45883915f3d6bae0715a96566a9.jpg,90,120,10800,9095,1705
train/images1016_png_jpg.rf.47a62f7fbded40a3bc97238477798ada.jpg,83,113,9379,7838,1541
train/images1010_png_jpg.rf.1907e7372123285e83652a487c14382c.jpg,109,109,11881,9029,2852
train/images1016_png_jpg.rf.71281378c286e3fc8afbfc720ebe02ee.jpg,123,119,14637,12048,2589
train/images1026_png_jpg.rf.043039548d7702026011be310c441db0.jpg,124,124,15376,12914,2462
train/images1030_png_jpg.rf.cf45f3f1169dc4884c4232678b48fa17.jpg,16,26,416,297,119
train/images1034_png_jpg.rf.c3cf58a733c0054c8c21aa5f44a148cd.jpg,83,93,7719,5664,2055
train/images1040_png_jpg.rf.390623408a165ec4f7e2127a245de6ea.jpg,67,144,9648,6444,3204
train/images1065_png_jpg.rf.728614ef66f79363554896429563d26b.jpg,114,86,9804,6374,3430
train/images1026_png_jpg.rf.7f43c1d03b69ca0d250b1453f24a60d7.jpg,100,127,12700,10413,2287
train/images1026_png_jpg.rf.f14ca34f95869ce2804c1627ca8bc6d9.jpg,130,133,17290,14459,2831
train/images1032_png_jpg.rf.5ec319e953f6fd508489a411b619f304.jpg,69,84,5796,4203,1593
train/images1032_png_jpg.rf.a1feb3358dbbeedce1758a541692d13e.jpg,55,83,4565,3296,1269
train/images1033_png_jpg.rf.57c6478047698710b68dee1507c7ce9a.jpg,81,90,7290,5247,2043
train/images1033_png_jpg.rf.f2baf5d85ab227c251af7b74ef1209de.jpg,62,87,5394,3838,1556
train/images1034_png_jpg.rf.96a920ddba6d9da58c80894d91becca5.jpg,94,99,9306,6590,2716
train/images1034_png_jpg.rf.c74fefea10fd48d785eb85034fc04b85.jpg,96,93,8928,6303,2625
train/images1035_png_jpg.rf.26c43e19aa232b43ceb7a64ac9eedd94.jpg,104,101,10504,7729,2775
train/images1035_png_jpg.rf.d173ba4e7a93cfec3a5fa0231eed6412.jpg,99,100,9900,7359,2541
train/images1035_png_jpg.rf.e04fe765873d6f6adc45c3ac91d4f21a.jpg,121,106,12826,8818,4008
train/images1038_png_jpg.rf.10367eb9d127b61572bc33fdd39cc6c9.jpg,164,129,21156,15285,5871
train/images1038_png_jpg.rf.4ec7c70aec228ba30d799f9dafd1b681.jpg,165,129,21285,15421,5864
train/images1038_png_jpg.rf.98abbf6f8079e88f9ea3a1b509104f4c.jpg,167,130,21710,15766,5944
train/images1039_png_jpg.rf.8b5cd60b88c251159578e597b4faa8ba.jpg,141,147,20727,16582,4145
train/images1039_png_jpg.rf.9606d0ecebbc6bfd0e6fb7d699d4c436.jpg,152,149,22648,18634,4014
train/images1039_png_jpg.rf.b5765da22b4a206b026bc765bddaf535.jpg,143,150,21450,17343,4107
train/images1040_png_jpg.rf.6ef3ca92226566e890629cd23b51b928.jpg,55,136,7480,4722,2758
train/images1040_png_jpg.rf.9a07fdb29bdb587a3a791afaf27d12cc.jpg,102,155,15810,11620,4190
train/images1047_png_jpg.rf.14ede0293315bd5629b0b35564482b6b.jpg,215,146,31390,25834,5556
train/images1047_png_jpg.rf.d875e497795159d191d87e7979b1cf0b.jpg,232,146,33872,27688,6184
train/images1047_png_jpg.rf.dc5073439b671c4dfa38b3b3c9cae99f.jpg,228,145,33060,27281,5779
train/images1065_png_jpg.rf.70c9edd46756b1a64117e5ee94ee669e.jpg,123,92,11316,7383,3933
train/images1065_png_jpg.rf.d4fbba4e059613503e6f09bb3021eac4.jpg,129,97,12513,8072,4441
train/images1081_png_jpg.rf.4eac0a461379e2b202e440cb377f38b6.jpg,105,187,19635,11833,7802
train/images1082_png_jpg.rf.07da7a22e990801653d17de98a05f0c3.jpg,72,182,13104,7748,5356
train/images1082_png_jpg.rf.b2db4d622da664e7bfd6f3f82c519740.jpg,80,179,14320,9160,5160
train/images1083_png_jpg.rf.133c4571a70483671fcf8c2ee126d64f.jpg,88,195,17160,10877,6283
train/images1083_png_jpg.rf.6ecbe90047468a7bb22d20cf7fb236c8.jpg,82,187,15334,9642,5692
train/images1083_png_jpg.rf.e512a9e7876cff590e03317519ba13c5.jpg,79,188,14852,9211,5641
train/images1084_png_jpg.rf.19ab3f25ee1b1bbcb470f4fce510c16c.jpg,120,193,23160,14031,9129
train/images1084_png_jpg.rf.7236ff6a46df506c83215a4cf8fa7fe0.jpg,116,194,22504,13585,8919
train/images1084_png_jpg.rf.a459e34eed3b087bef95eec6129b21f1.jpg,133,199,26467,15706,10761
train/images1085_png_jpg.rf.05ced665f5a4d5eaaa1e8290b32c7c90.jpg,109,209,22781,13849,8932
train/images1085_png_jpg.rf.90463c3cfbd6695ec3d13cba7d4622ca.jpg,163,209,34067,18675,15392
train/images1086_png_jpg.rf.7a66ef397f8a40b28cc36841179e29f9.jpg,136,216,29376,18727,10649
train/images1086_png_jpg.rf.99f16642bc0bf6ca43adde0c3bdb4d89.jpg,161,209,33649,18301,15348
train/images1086_png_jpg.rf.a32139b4fd7808763341044756f37eac.jpg,147,207,30429,18094,12335
train/images1087_png_jpg.rf.24b1e4a4f5a18cbf84bb9d1241d83906.jpg,185,223,41255,22421,18834
train/images1087_png_jpg.rf.4183ccf731a9d155c50923f11f2d33bc.jpg,177,224,39648,21689,17959
train/images1087_png_jpg.rf.c77239894794d26a749a2b2d51decfb4.jpg,176,214,37664,21166,16498
train/images1088_png_jpg.rf.46c4c6827220f9b63d153979e051ef40.jpg,207,242,50094,27528,22566
train/images1088_png_jpg.rf.50f52307f608552aaaa45cc696cf4736.jpg,197,238,46886,26140,20746
train/images1088_png_jpg.rf.ad1b41e597ba1002aba6c10021ac2261.jpg,203,243,49329,27025,22304
train/images1092_png_jpg.rf.17bb9e21b181f1f23b7eb057b4b09794.jpg,237,260,61620,35142,26478
train/images1092_png_jpg.rf.adb595d65d0f92e0e597e312e94bc153.jpg,219,283,61977,36984,24993
train/images1093_png_jpg.rf.46a69cb037062f9744dc142f26f9385a.jpg,243,287,69741,40097,29644
train/images1093_png_jpg.rf.4be78d28d8c870714b6d4bc106fa5d93.jpg,212,296,62752,38090,24662
train/images1093_png_jpg.rf.5b6b469de112f4a53df7a22e926129f1.jpg,252,300,75600,44013,31587
train/images1094_png_jpg.rf.b784387e055c01f3e82e8fb2be81fc14.jpg,244,314,76616,46877,29739
train/images1094_png_jpg.rf.dc79a794be9071b2b7c18a82671432e7.jpg,225,311,69975,42678,27297
train/images1094_png_jpg.rf.df941f059b0ba055806fb2739915769a.jpg,209,299,62491,39425,23066
train/images1095_png_jpg.rf.19618fd2354050d736f996584dce0c96.jpg,191,299,57109,33826,23283
train/images1095_png_jpg.rf.ef908784fe7ed09bcf54877c29ee4376.jpg,184,282,51888,30927,20961
train/images1095_png_jpg.rf.f4b4ed52dde2ba650943310319d2e84a.jpg,173,265,45845,27829,18016
train/images1096_png_jpg.rf.6935a98c42b7c6cb49451c74dfbd775a.jpg,193,306,59058,34383,24675
train/images1096_png_jpg.rf.9edff9354bc1b00d1ab42491b9e2fef2.jpg,193,293,56549,33178,23371
train/images1097_png_jpg.rf.062780c5453fc9dec55892e0cdb51544.jpg,75,102,7650,5054,2596
train/images1097_png_jpg.rf.4c7c885e14f9c3af0ecf4d771e4a1cf8.jpg,78,105,8190,5423,2767
train/images1097_png_jpg.rf.9b535634382645159c7f59a35908c67b.jpg,75,101,7575,5179,2396
train/images1099_png_jpg.rf.449b65908969839791cfabf3be729f71.jpg,85,108,9180,6148,3032
train/images1099_png_jpg.rf.51744086fcd901e39f7eb79f5d7745a1.jpg,82,103,8446,5654,2792
train/images1099_png_jpg.rf.712f7bafef7cbcc2ea7927df1de221a9.jpg,79,101,7979,5288,2691
train/images1163_png_jpg.rf.45b1fe27a5d1f85f74bd32127f6170a3.jpg,90,103,9270,6902,2368
train/images1163_png_jpg.rf.fc7c33cac7ba94d933c6e372adcfb512.jpg,91,104,9464,6996,2468
train/images1165_png_jpg.rf.a7427cd1a9346929f279689de81a120f.jpg,175,139,24325,17776,6549
train/images1165_png_jpg.rf.bac0216a53fb1a31ff1e72e4344e7994.jpg,146,148,21608,15064,6544
train/images1165_png_jpg.rf.e726f13c3cc17fdb3142999351c7319c.jpg,143,141,20163,13994,6169
train/images1174_png_jpg.rf.2e43c167b65003cb797fc2cdb4b69985.jpg,62,58,3596,2883,713
train/images1174_png_jpg.rf.64f956836e6c6f4c9f885d903fe4ba10.jpg,55,38,2090,1675,415
train/images1174_png_jpg.rf.9bc4cca51aa5510665fb5533697ec4fe.jpg,58,40,2320,1787,533
train/images117_png_jpg.rf.cab6261e0c59c30cbeb909e2ee082557.jpg,150,129,19350,10183,9167
train/images121_png_jpg.rf.1084f2e63b3c4417bb547c4b9dd10dbc.jpg,61,122,7442,5865,1577
train/images121_png_jpg.rf.f697313ba68d5f4f41548100eef9054f.jpg,58,120,6960,5505,1455
train/images124_png_jpg.rf.33246038b122b7e8168c45335b194e03.jpg,74,67,4958,4136,822
train/images124_png_jpg.rf.60ce846673ec7f883a7f85bceb023f41.jpg,86,82,7052,5152,1900
train/images124_png_jpg.rf.752ce4b7e8d1aacd7917fdb2601b47b1.jpg,90,87,7830,5560,2270
train/images125_png_jpg.rf.2ac180621c682825d47435a8cd971005.jpg,301,226,68026,42740,25286
train/images125_png_jpg.rf.59edd55c6e5ae13447da6fb2388cb95f.jpg,277,240,66480,46095,20385
train/images1261_png_jpg.rf.186772b249b0d99eaff31fc7ab4c8998.jpg,42,96,4032,2774,1258
train/images1261_png_jpg.rf.2f42acd28c3a6ae7fbb53a2c55e4c570.jpg,33,92,3036,2062,974
train/images126_png_jpg.rf.154c7db2506619181fdebb5cf66c8e8b.jpg,134,91,12194,9666,2528
train/images126_png_jpg.rf.4d89dd514675d6b333da7f41b74ce006.jpg,141,91,12831,10262,2569
train/images126_png_jpg.rf.53d8b26c40271c3893dffc1a49d87235.jpg,177,100,17700,13465,4235
train/images137_png_jpg.rf.7394560a64789b0fa7e9f8f7fb2b1c8f.jpg,193,290,55970,37758,18212
train/images137_png_jpg.rf.7394560a64789b0fa7e9f8f7fb2b1c8f.jpg,105,172,18060,13451,4609
train/images137_png_jpg.rf.a422f7401fbe90b4bebc8eedd0e3e234.jpg,238,303,72114,51237,20877
train/images137_png_jpg.rf.a422f7401fbe90b4bebc8eedd0e3e234.jpg,70,176,12320,7219,5101
train/images137_png_jpg.rf.d7b0fe630bd3ce438b026c215226c4f6.jpg,231,317,73227,50336,22891
train/images137_png_jpg.rf.d7b0fe630bd3ce438b026c215226c4f6.jpg,69,198,13662,9059,4603
train/images140_png_jpg.rf.35ad6461c88e0e502b301d65306826c5.jpg,171,206,35226,26891,8335
train/images140_png_jpg.rf.35ad6461c88e0e502b301d65306826c5.jpg,139,233,32387,25396,6991
train/images140_png_jpg.rf.943d68e48b5b53a2c8e04b75ad9a32e6.jpg,96,211,20256,15239,5017
train/images140_png_jpg.rf.943d68e48b5b53a2c8e04b75ad9a32e6.jpg,188,203,38164,29214,8950
train/images140_png_jpg.rf.b79bc71eec6a60094472623fae573689.jpg,129,224,28896,22407,6489
train/images140_png_jpg.rf.b79bc71eec6a60094472623fae573689.jpg,178,201,35778,25911,9867
train/images14_png_jpg.rf.2b66c48315225ebc8ece14b291d5418a.jpg,211,90,18990,13510,5480
train/images14_png_jpg.rf.730456635614a192ed20e937e4c9fb4f.jpg,227,95,21565,15446,6119
train/images14_png_jpg.rf.ca8c87cf285a323840795c815ce6521a.jpg,215,89,19135,13683,5452
train/images156_png_jpg.rf.771526080187dceae2fd83483f222c7d.jpg,77,105,8085,6902,1183
train/images156_png_jpg.rf.7dee83e1a3a6728175a163294ef9ba55.jpg,78,106,8268,6872,1396
train/images168_png_jpg.rf.7cf14b5590eacdb59426c2684862a408.jpg,73,128,9344,7216,2128
train/images168_png_jpg.rf.81c5b6178e4cfe8a84be2c4727c06207.jpg,82,133,10906,8167,2739
train/images168_png_jpg.rf.b32b504859dc80e2232283005bca1246.jpg,75,130,9750,7647,2103
train/images169_png_jpg.rf.2677a3e19c3bc34dc5de6510bbb6732a.jpg,85,141,11985,9400,2585
train/images1085_png_jpg.rf.c57107ea58bd9c3f05fe8eb9062cf658.jpg,110,208,22880,14499,8381
train/images1092_png_jpg.rf.1ae67551564af82d48c801584670ef16.jpg,200,293,58600,36665,21935
train/images1096_png_jpg.rf.4d633eabb6ecbf209a8176f9fa36d4e0.jpg,185,282,52170,31674,20496
train/images1163_png_jpg.rf.7f29e48062c3c67b4f0369fa7a279aad.jpg,93,103,9579,6921,2658
train/images1185_png_jpg.rf.29c26d26e539a21580408bfaf7b5e885.jpg,66,39,2574,1959,615
train/images125_png_jpg.rf.c392d6809261360611cb375cfb2936e3.jpg,314,233,73162,46095,27067
train/images156_png_jpg.rf.39450569e3e4d8ca9634239afcf699a9.jpg,99,112,11088,9433,1655
train/images169_png_jpg.rf.b51ff27cfaa05cc55e168b2aee574350.jpg,89,144,12816,10047,2769
train/images171_png_jpg.rf.023d7bd9144b1919c5bf9fe7bdc3565d.jpg,127,172,21844,17445,4399
train/images171_png_jpg.rf.875cb1ba42c893b1d25ab88db4f74e09.jpg,133,178,23674,19155,4519
train/images171_png_jpg.rf.ec5f332b2aee868000b3d271cd15ab16.jpg,126,168,21168,16806,4362
train/images172_png_jpg.rf.17c30bd0787827d8dc6f023cce16bb28.jpg,156,189,29484,24199,5285
train/images172_png_jpg.rf.2ff81b3f2948d95c4d3465dafe6506a1.jpg,144,180,25920,20892,5028
train/images172_png_jpg.rf.91ed3cdbc14a4979a992a1d4bf2094ae.jpg,142,177,25134,20391,4743
train/images173_png_jpg.rf.95ebc5ab51abe20d6eafed0e01df9ad5.jpg,128,211,27008,21480,5528
train/images173_png_jpg.rf.e207f42ebf6f9a3806dbf272febbcf0a.jpg,179,209,37411,30659,6752
train/images207_png_jpg.rf.73364a6fa5d2123c605dbae784f44808.jpg,148,61,9028,6407,2621
train/images217_png_jpg.rf.8f3968baf81f1dcbe0499d48d9cd7542.jpg,170,78,13260,9935,3325
train/images217_png_jpg.rf.96264036fe7a427b730cf5e4fa7b0367.jpg,157,76,11932,8792,3140
train/images217_png_jpg.rf.96264036fe7a427b730cf5e4fa7b0367.jpg,42,61,2562,1992,570
train/images217_png_jpg.rf.d70e057e2223566b8def9a178a3c1eba.jpg,173,76,13148,9635,3513
train/images21_png_jpg.rf.3102be645941fbb1aef960bd84e6bca7.jpg,219,264,57816,33938,23878
train/images21_png_jpg.rf.6d18d7ac26f203b5cac8a054efa1abc6.jpg,229,272,62288,35811,26477
train/images21_png_jpg.rf.74aedf39db9b1ba42b17058a53a6efe1.jpg,287,293,84091,53648,30443
train/images223_png_jpg.rf.788ff33eadfd310b12a3106e217028a9.jpg,61,163,9943,5513,4430
train/images223_png_jpg.rf.e83ee4a4e259fea7471a77750a1f86f6.jpg,65,150,9750,7284,2466
train/images223_png_jpg.rf.ed39c22c379545ce9e9a1e8acfb3d67e.jpg,51,35,1785,1257,528
train/images224_png_jpg.rf.445fd5de3e2c02a2d2c9666bb419e7c5.jpg,113,160,18080,12583,5497
train/images224_png_jpg.rf.4cf5556fdb8dadfa108045ffc9b30dd0.jpg,115,194,22310,14369,7941
train/images224_png_jpg.rf.4cf5556fdb8dadfa108045ffc9b30dd0.jpg,105,135,14175,10768,3407
train/images224_png_jpg.rf.dd5eeba2db144910d9be06b67b230151.jpg,115,197,22655,14329,8326
train/images224_png_jpg.rf.dd5eeba2db144910d9be06b67b230151.jpg,106,159,16854,11210,5644
train/images227_png_jpg.rf.15d15a2cffc9eb45851f7f92e75d401f.jpg,172,148,25456,17133,8323
train/images227_png_jpg.rf.15d15a2cffc9eb45851f7f92e75d401f.jpg,246,162,39852,27876,11976
train/images227_png_jpg.rf.c6b1757152032c6794334a2b7dc61334.jpg,163,117,19071,13128,5943
train/images229_png_jpg.rf.9f3ba155f376ba0c3a5a6bb3f89d21eb.jpg,202,121,24442,16712,7730
train/images229_png_jpg.rf.9f3ba155f376ba0c3a5a6bb3f89d21eb.jpg,47,88,4136,3061,1075
train/images229_png_jpg.rf.a623c31e8efa6c2a9a125d9fbfc2f18a.jpg,214,136,29104,20231,8873
train/images229_png_jpg.rf.a623c31e8efa6c2a9a125d9fbfc2f18a.jpg,289,160,46240,22126,24114
train/images229_png_jpg.rf.b857847cdfcd10db8e0018dad9885aad.jpg,213,148,31524,22087,9437
train/images229_png_jpg.rf.b857847cdfcd10db8e0018dad9885aad.jpg,302,153,46206,23701,22505
train/images229_png_jpg.rf.b857847cdfcd10db8e0018dad9885aad.jpg,26,79,2054,1322,732
train/images231_png_jpg.rf.8e1e7b55f1a89c449d203c8eafb110a1.jpg,85,110,9350,6090,3260
train/images231_png_jpg.rf.8e1e7b55f1a89c449d203c8eafb110a1.jpg,131,142,18602,13402,5200
train/images231_png_jpg.rf.e08db775102c7e91354e8100355190d1.jpg,80,112,8960,6699,2261
train/images231_png_jpg.rf.e08db775102c7e91354e8100355190d1.jpg,133,87,11571,7179,4392
train/images231_png_jpg.rf.ea6f3e23b9ea6e004ff1f5b9b0e00ae8.jpg,159,110,17490,12874,4616
train/images231_png_jpg.rf.ea6f3e23b9ea6e004ff1f5b9b0e00ae8.jpg,76,101,7676,5650,2026
train/images232_png_jpg.rf.43e6938f25200e901ab66ccea5f43478.jpg,98,117,11466,8406,3060
train/images232_png_jpg.rf.f646a8118eb378dc6d254b586af475dd.jpg,90,121,10890,7718,3172
train/images233_png_jpg.rf.2446c3e36c9a55606a5954629f68fd9f.jpg,106,122,12932,8391,4541
train/images233_png_jpg.rf.4a4e41addb2358b58234366dcd5c7502.jpg,106,118,12508,8171,4337
train/images233_png_jpg.rf.921e597a205270365c9b3c8988213488.jpg,110,129,14190,9197,4993
train/images234_png_jpg.rf.6061a9babfdbb104946c7828fb558c1c.jpg,126,136,17136,11226,5910
train/images234_png_jpg.rf.667aad58f5869416dadcdbb53fc1a852.jpg,129,142,18318,12281,6037
train/images234_png_jpg.rf.c488f702d4ff4fdd430aab9c11dcd81d.jpg,127,140,17780,12086,5694
train/images235_png_jpg.rf.4bd5da51b62d8d7cb5f0f5c7911bf7f1.jpg,145,142,20590,13960,6630
train/images235_png_jpg.rf.dd03547296dd0d0a6659b12dc62e27be.jpg,144,137,19728,13240,6488
train/images235_png_jpg.rf.fe4f99774e3ce9e1db755d5848133dd3.jpg,136,132,17952,12364,5588
train/images236_png_jpg.rf.9ed590e2f7ca8162454ea9ebfbdc9aed.jpg,140,140,19600,13801,5799
train/images236_png_jpg.rf.c516583ad593eed4596fe484921135a3.jpg,142,151,21442,14393,7049
train/images237_png_jpg.rf.5ab7a342606889fc38e847a86f0fafd3.jpg,87,141,12267,7221,5046
train/images237_png_jpg.rf.7479693bfa16e7b2d0aee99a5a72b650.jpg,123,164,20172,14288,5884
train/images238_png_jpg.rf.35bd9cc87d169c609683aa54f719f857.jpg,121,108,13068,8591,4477
train/images238_png_jpg.rf.a39f9c0b4be90574cc0ab81e130e3455.jpg,164,156,25584,14597,10987
train/images238_png_jpg.rf.fbedf9f2d1d3258c2f512ce3b4c8d6de.jpg,117,87,10179,7684,2495
train/images249_png_jpg.rf.2cb624135184ea87d2218f9acecd4cc5.jpg,213,175,37275,23582,13693
train/images249_png_jpg.rf.f1a6e7100f656d71f86a2ec35dc2b3e1.jpg,204,175,35700,20951,14749
train/images254_png_jpg.rf.74f0ecfc45b2279ee465cd2f85370782.jpg,101,115,11615,9033,2582
train/images254_png_jpg.rf.a5424e541974fdc40115300330762a0c.jpg,99,128,12672,10324,2348
train/images254_png_jpg.rf.df1a4009623683e1128247bbc4472871.jpg,97,152,14744,11001,3743
train/images287_png_jpg.rf.64e8290876f58faa7c557f1a2bd317fd.jpg,103,128,13184,9591,3593
train/images173_png_jpg.rf.38c9cc7890caf4455f0697787669ed64.jpg,134,210,28140,22304,5836
train/images207_png_jpg.rf.8b66bb6dc50deac80e1f17fd6295c04a.jpg,144,66,9504,7023,2481
train/images227_png_jpg.rf.cd71f666a365d5d63294d6f5dc668984.jpg,170,163,27710,19193,8517
train/images227_png_jpg.rf.cd71f666a365d5d63294d6f5dc668984.jpg,194,145,28130,17166,10964
train/images232_png_jpg.rf.699bab57fed160e2f1b13e13d610ed06.jpg,97,117,11349,7533,3816
train/images236_png_jpg.rf.87c3e0bf780acfb3839c19c601255200.jpg,146,144,21024,14760,6264
train/images249_png_jpg.rf.72f757707c2d377354fb4e4ad0996847.jpg,191,177,33807,20575,13232
train/images1082_png_jpg.rf.0027d255e51683fdb0c4362592ee9e33.jpg,83,183,15189,9791,5398
train/images169_png_jpg.rf.37a4c1542d0268d159e1425429cb7b90.jpg,83,138,11454,8943,2511
train/images287_png_jpg.rf.f714afc3b2e5873421c2f2031dac72ac.jpg,125,154,19250,14325,4925
train/images417_png_jpg.rf.089f0c2f466f68088a91619174b7e961.jpg,69,105,7245,5460,1785
train/images493_png_jpg.rf.3d03821b4b050fb033d5b5196c3bd718.jpg,64,93,5952,4063,1889
train/images725_png_jpg.rf.79b9accafa694c85581b863fb4cc527a.jpg,140,146,20440,13565,6875
train/images725_png_jpg.rf.79b9accafa694c85581b863fb4cc527a.jpg,129,152,19608,13783,5825
train/images771_png_jpg.rf.ca916544cc9f1b08df5be089dca5fbea.jpg,187,118,22066,16231,5835
train/images771_png_jpg.rf.ca916544cc9f1b08df5be089dca5fbea.jpg,168,145,24360,18767,5593
train/images928_png_jpg.rf.031feac7928c1e4b33b703777026cb08.jpg,210,364,76440,49631,26809
train/images288_png_jpg.rf.126f475057844e3eba22eb589a765ce4.jpg,80,73,5840,2851,2989
train/images289_png_jpg.rf.0cf343866c1753dbc926f772790e7ac2.jpg,146,93,13578,6626,6952
train/images289_png_jpg.rf.a8d417097e1197426bddc2703db9dbb2.jpg,147,91,13377,6394,6983
train/images289_png_jpg.rf.c327488b1f209773f4950d8899ae2d80.jpg,142,87,12354,6071,6283
train/images290_png_jpg.rf.3c69d2121b21f0656889cc2d0d5f78a4.jpg,184,106,19504,10633,8871
train/images290_png_jpg.rf.dbf47b89301ce847c7a75dcef173f37b.jpg,208,101,21008,12328,8680
train/images290_png_jpg.rf.f9e21570698332e84ff5451d08c421e8.jpg,224,108,24192,14017,10175
train/images309_png_jpg.rf.1e00f4dcc3b05c31e8a974306899a242.jpg,45,161,7245,4547,2698
train/images311_png_jpg.rf.827eeb92d8174f79d2f1cf7ef0599259.jpg,169,268,45292,27496,17796
train/images311_png_jpg.rf.a07f42ab887c787d1999ea20d83111e0.jpg,184,263,48392,28116,20276
train/images311_png_jpg.rf.d2fcb04e90bf6a23e78f310ef9151a2b.jpg,123,279,34317,22758,11559
train/images36_png_jpg.rf.342d1d53e8a819d4b99e224e68382ef2.jpg,66,61,4026,2658,1368
train/images36_png_jpg.rf.69b9b099fec5a226b56fdbb3ccebc2ae.jpg,59,68,4012,2587,1425
train/images37_png_jpg.rf.4cb7bd0a908898058c747cbe9df1cbd8.jpg,180,113,20340,12459,7881
train/images37_png_jpg.rf.f7aa855673a7c7ddb0b481af73f1ec3c.jpg,148,113,16724,9759,6965
train/images384_png_jpg.rf.b1626213a01c92ba0348d1077a86b24a.jpg,104,238,24752,17493,7259
train/images384_png_jpg.rf.dccb1e6a6569d8b905f5a0867f37ace4.jpg,117,255,29835,20756,9079
train/images385_png_jpg.rf.194a150387097c4728e4c91eb656055b.jpg,139,256,35584,23419,12165
train/images385_png_jpg.rf.6347f13c96f6cfb54c7b3b94f7ae3a9c.jpg,122,244,29768,20938,8830
train/images385_png_jpg.rf.67ff493a4433f8c772ec0f40da830ed5.jpg,129,234,30186,20500,9686
train/images39_png_jpg.rf.a72437bc1bde8dd67018d7a27d25fa20.jpg,305,147,44835,30734,14101
train/images39_png_jpg.rf.b2cfb28bc330c80f115319d22da32d9a.jpg,269,139,37391,25815,11576
train/images3_png_jpg.rf.b9fd0cce3806e6534d38132a38e25294.jpg,159,74,11766,9194,2572
train/images3_png_jpg.rf.cb84b0b035ae002ca26f0b61815a17e1.jpg,166,72,11952,8987,2965
train/images3_png_jpg.rf.ee96dfaf76c9359c4bc9d1aa3dd01b2f.jpg,168,75,12600,9621,2979
train/images403_png_jpg.rf.6aca2829ab4669ae640af0f058fe0ba3.jpg,96,220,21120,17396,3724
train/images403_png_jpg.rf.91af6f386bbe6d37ba5dbb5f239f52b4.jpg,55,232,12760,10052,2708
train/images403_png_jpg.rf.a9cf106cd219efbe8d6e1d9c05aa8c7c.jpg,73,215,15695,13416,2279
train/images404_png_jpg.rf.3d5e6e57afc9f8ad373f7f2fe15dd83c.jpg,119,240,28560,22891,5669
train/images404_png_jpg.rf.91750cdbbf690b23cb18034531f4e08b.jpg,93,241,22413,18024,4389
train/images405_png_jpg.rf.2530c52ff26eedfe75f329c7ae618aa0.jpg,154,282,43428,35435,7993
train/images405_png_jpg.rf.802d25b392bbb3a871629a62f9b2c07e.jpg,142,264,37488,30663,6825
train/images405_png_jpg.rf.c32f3f840d9367513f7844714c6cbcde.jpg,140,257,35980,29610,6370
train/images40_png_jpg.rf.673b38877aacf9395886342f46fdc6fd.jpg,225,165,37125,26401,10724
train/images40_png_jpg.rf.99326ec62b7e38b5140234a7e75e2d09.jpg,208,163,33904,23181,10723
train/images40_png_jpg.rf.9ba406b7bfa0640d132e978d896b8610.jpg,206,170,35020,24394,10626
train/images416_png_jpg.rf.a3f52c7ba65d1216047237da17b0ea85.jpg,55,101,5555,4008,1547
train/images416_png_jpg.rf.f7ab2c8bb02236faa79aa7d90e611d85.jpg,66,103,6798,5137,1661
train/images39_png_jpg.rf.e262e67dc91443c2c86dedfb5fd81e2a.jpg,287,145,41615,28391,13224
train/images404_png_jpg.rf.7331d4c058abd793bbc2939f1180668d.jpg,122,245,29890,24165,5725
train/images417_png_jpg.rf.0e989066e9db59edb667c7c91747296a.jpg,69,104,7176,5459,1717
train/images417_png_jpg.rf.1ffe5a5e9be0d2dcc4dc457be285a537.jpg,58,99,5742,4325,1417
train/images418_png_jpg.rf.8cb3bf303c544e84997a8e1aadfbdf76.jpg,92,120,11040,8651,2389
train/images418_png_jpg.rf.adc9ba3fbaa2cd5df5bc7afc3af7ac26.jpg,86,119,10234,8166,2068
train/images418_png_jpg.rf.fd575521634f702a96a43e4dd4250469.jpg,86,118,10148,8199,1949
train/images429_png_jpg.rf.0ddba0f68234236312a7c9d34fa43e2f.jpg,48,128,6144,4723,1421
train/images429_png_jpg.rf.0ddba0f68234236312a7c9d34fa43e2f.jpg,110,76,8360,5244,3116
train/images429_png_jpg.rf.0ddba0f68234236312a7c9d34fa43e2f.jpg,136,95,12920,5964,6956
train/images429_png_jpg.rf.ab1aa8e8b05a5ded67dc444362ea78f4.jpg,143,72,10296,7313,2983
train/images429_png_jpg.rf.b81219a115bd5ac29489ec86d60519a5.jpg,153,86,13158,7759,5399
train/images431_png_jpg.rf.80beb2532d9a1e0afcf4c9281c2ace39.jpg,73,136,9928,7811,2117
train/images431_png_jpg.rf.80beb2532d9a1e0afcf4c9281c2ace39.jpg,165,99,16335,6961,9374
train/images431_png_jpg.rf.813c521bfa129fab657edc55ff218b19.jpg,74,137,10138,8155,1983
train/images431_png_jpg.rf.813c521bfa129fab657edc55ff218b19.jpg,160,98,15680,6963,8717
train/images433_png_jpg.rf.6ad568f1ec59c56bff3fb3d47ae94a49.jpg,130,155,20150,15347,4803
train/images433_png_jpg.rf.6ad568f1ec59c56bff3fb3d47ae94a49.jpg,174,113,19662,9932,9730
train/images433_png_jpg.rf.c1d251b3465666ceb6674b9ba0bd6e89.jpg,124,152,18848,14831,4017
train/images433_png_jpg.rf.c1d251b3465666ceb6674b9ba0bd6e89.jpg,192,111,21312,9734,11578
train/images433_png_jpg.rf.fa0f874e8172fd8a9ebf7256681cb880.jpg,123,150,18450,14451,3999
train/images433_png_jpg.rf.fa0f874e8172fd8a9ebf7256681cb880.jpg,176,107,18832,9222,9610
train/images434_png_jpg.rf.10ad14592f31e5816f9cdf64457f2615.jpg,143,167,23881,18757,5124
train/images434_png_jpg.rf.10ad14592f31e5816f9cdf64457f2615.jpg,179,114,20406,10958,9448
train/images434_png_jpg.rf.8a044f43ed073123b8a1fe8e3e994142.jpg,158,173,27334,20692,6642
train/images434_png_jpg.rf.8a044f43ed073123b8a1fe8e3e994142.jpg,136,111,15096,9141,5955
train/images434_png_jpg.rf.c10ba508a9ca28af18657390801200bb.jpg,149,171,25479,19354,6125
train/images434_png_jpg.rf.c10ba508a9ca28af18657390801200bb.jpg,164,112,18368,10384,7984
train/images435_png_jpg.rf.27325bee8c75386c0170ba0e7db9e603.jpg,188,183,34404,25466,8938
train/images435_png_jpg.rf.27325bee8c75386c0170ba0e7db9e603.jpg,174,129,22446,13320,9126
train/images435_png_jpg.rf.87c35cddbd7827e2b33ebe603419cb63.jpg,172,174,29928,22060,7868
train/images435_png_jpg.rf.87c35cddbd7827e2b33ebe603419cb63.jpg,153,126,19278,10938,8340
train/images435_png_jpg.rf.9e6cca957f2e407ea7ac0b1a475913d7.jpg,175,177,30975,22694,8281
train/images435_png_jpg.rf.9e6cca957f2e407ea7ac0b1a475913d7.jpg,126,103,12978,8037,4941
train/images437_png_jpg.rf.b734ab9a3b8f1cbf77a1e071b146edf3.jpg,196,189,37044,27186,9858
train/images437_png_jpg.rf.b734ab9a3b8f1cbf77a1e071b146edf3.jpg,189,129,24381,13710,10671
train/images437_png_jpg.rf.e0c71d11417befbb90e21c91a4f997cb.jpg,200,193,38600,28493,10107
train/images437_png_jpg.rf.e0c71d11417befbb90e21c91a4f997cb.jpg,193,125,24125,13799,10326
train/images438_png_jpg.rf.0a68c711bb3fd1ea5a365bc78301cdf6.jpg,234,208,48672,36008,12664
train/images438_png_jpg.rf.538452fe100ed479f8882f8e51afb5de.jpg,225,197,44325,32605,11720
train/images438_png_jpg.rf.66f4e840d73273c0d5beaf5839b7b22a.jpg,213,202,43026,32661,10365
train/images43_png_jpg.rf.3a2242b99a56bec4944ca6080c90b141.jpg,208,51,10608,8565,2043
train/images43_png_jpg.rf.d9f19dbe0c17c9655a389f3a2cb0cdcb.jpg,236,59,13924,10570,3354
train/images43_png_jpg.rf.e240dcf993a9ad1998041e44b960625f.jpg,236,59,13924,10683,3241
train/images442_png_jpg.rf.1b713fed33a311490783b9af1ce6e216.jpg,91,142,12922,7595,5327
train/images442_png_jpg.rf.1b713fed33a311490783b9af1ce6e216.jpg,189,110,20790,15114,5676
train/images442_png_jpg.rf.1b713fed33a311490783b9af1ce6e216.jpg,233,172,40076,29269,10807
train/images442_png_jpg.rf.5f11d74d038d5de6b50d4c9828d638db.jpg,231,178,41118,30324,10794
train/images442_png_jpg.rf.5f11d74d038d5de6b50d4c9828d638db.jpg,170,98,16660,12914,3746
train/images442_png_jpg.rf.5f11d74d038d5de6b50d4c9828d638db.jpg,72,105,7560,5597,1963
train/images442_png_jpg.rf.74b9cf92dd6531c578f1371aa4c5f6a1.jpg,236,181,42716,31431,11285
train/images442_png_jpg.rf.74b9cf92dd6531c578f1371aa4c5f6a1.jpg,174,90,15660,11611,4049
train/images442_png_jpg.rf.74b9cf92dd6531c578f1371aa4c5f6a1.jpg,74,106,7844,5542,2302
train/images443_png_jpg.rf.bbb29b7dbdfdecb56aa21ecf8d7fe239.jpg,184,247,45448,31571,13877
train/images443_png_jpg.rf.bbb29b7dbdfdecb56aa21ecf8d7fe239.jpg,120,222,26640,16701,9939
train/images443_png_jpg.rf.c32ffa6182281fee67c55b9bab746381.jpg,176,243,42768,28986,13782
train/images443_png_jpg.rf.c32ffa6182281fee67c55b9bab746381.jpg,94,212,19928,13665,6263
train/images453_png_jpg.rf.3047f88d9c8721fc89f4f64965566ddc.jpg,146,114,16644,10731,5913
train/images453_png_jpg.rf.3047f88d9c8721fc89f4f64965566ddc.jpg,135,115,15525,5542,9983
train/images453_png_jpg.rf.7ca15a004a24ea5254acfc8157b8d2b8.jpg,148,107,15836,10475,5361
train/images453_png_jpg.rf.7ca15a004a24ea5254acfc8157b8d2b8.jpg,132,124,16368,6500,9868
train/images453_png_jpg.rf.da984b933e3cc186e58047fd3e195286.jpg,141,106,14946,9557,5389
train/images453_png_jpg.rf.da984b933e3cc186e58047fd3e195286.jpg,126,108,13608,6063,7545
train/images46_png_jpg.rf.84fa5be964357676f7b3ccf934f59f6d.jpg,230,74,17020,13819,3201
train/images46_png_jpg.rf.84fa5be964357676f7b3ccf934f59f6d.jpg,68,93,6324,4832,1492
train/images46_png_jpg.rf.88b7605bb02bda149c1835d30a1e02fd.jpg,233,76,17708,13928,3780
train/images46_png_jpg.rf.88b7605bb02bda149c1835d30a1e02fd.jpg,76,91,6916,5381,1535
train/images46_png_jpg.rf.a5f0dec4bf1840d99b893752d8b38930.jpg,204,77,15708,12307,3401
train/images46_png_jpg.rf.a5f0dec4bf1840d99b893752d8b38930.jpg,75,89,6675,5184,1491
train/images46_png_jpg.rf.a5f0dec4bf1840d99b893752d8b38930.jpg,59,166,9794,7109,2685
train/images47_png_jpg.rf.1b424a1a375142f101ba9bae8e277b8e.jpg,98,109,10682,7801,2881
train/images47_png_jpg.rf.d6fb95c863e2ce8e8b6f16438cd52974.jpg,100,111,11100,8236,2864
train/images47_png_jpg.rf.d6fb95c863e2ce8e8b6f16438cd52974.jpg,76,175,13300,11375,1925
train/images47_png_jpg.rf.d6fb95c863e2ce8e8b6f16438cd52974.jpg,46,101,4646,3606,1040
train/images48_png_jpg.rf.42d8349fbf2f09b3d5ff9801ad3fb6f4.jpg,147,135,19845,14125,5720
train/images48_png_jpg.rf.42d8349fbf2f09b3d5ff9801ad3fb6f4.jpg,220,103,22660,16138,6522
train/images48_png_jpg.rf.42d8349fbf2f09b3d5ff9801ad3fb6f4.jpg,89,124,11036,8614,2422
train/images48_png_jpg.rf.dacfb87a0c96946e25a626050ba488b1.jpg,158,136,21488,15123,6365
train/images48_png_jpg.rf.dacfb87a0c96946e25a626050ba488b1.jpg,158,100,15800,12304,3496
train/images48_png_jpg.rf.e816d34baa2e10ed90d187b143c00467.jpg,123,131,16113,13260,2853
train/images48_png_jpg.rf.e816d34baa2e10ed90d187b143c00467.jpg,141,112,15792,11340,4452
train/images48_png_jpg.rf.e816d34baa2e10ed90d187b143c00467.jpg,193,152,29336,22554,6782
train/images493_png_jpg.rf.3c9b4f65fecfb58e417d602a02794828.jpg,62,93,5766,3887,1879
train/images431_png_jpg.rf.f41a8e55576e8871ba41ded91f03d204.jpg,101,140,14140,10901,3239
train/images431_png_jpg.rf.f41a8e55576e8871ba41ded91f03d204.jpg,153,100,15300,7209,8091
train/images437_png_jpg.rf.cc7a8c9f5bc2e662a304e75edb917978.jpg,195,187,36465,26971,9494
train/images437_png_jpg.rf.cc7a8c9f5bc2e662a304e75edb917978.jpg,247,149,36803,18495,18308
train/images443_png_jpg.rf.063d1fbe02dd6be0d0aae8cbe1d3399a.jpg,177,242,42834,29192,13642
train/images443_png_jpg.rf.063d1fbe02dd6be0d0aae8cbe1d3399a.jpg,99,215,21285,14597,6688
train/images47_png_jpg.rf.8398c1396e5aa453ee08ef8d422a7b0a.jpg,104,111,11544,8524,3020
train/images47_png_jpg.rf.8398c1396e5aa453ee08ef8d422a7b0a.jpg,65,116,7540,5536,2004
train/images47_png_jpg.rf.8398c1396e5aa453ee08ef8d422a7b0a.jpg,101,171,17271,15072,2199
train/images493_png_jpg.rf.de3ebf15d55985e030e4a525b32341eb.jpg,68,93,6324,4485,1839
train/images49_png_jpg.rf.1443ca752d41440487100ac1b36a3523.jpg,205,87,17835,13577,4258
train/images49_png_jpg.rf.1443ca752d41440487100ac1b36a3523.jpg,210,86,18060,13117,4943
train/images49_png_jpg.rf.3b9e37bddd0e06de9594919f02d45da3.jpg,179,72,12888,9619,3269
train/images49_png_jpg.rf.3b9e37bddd0e06de9594919f02d45da3.jpg,246,125,30750,22379,8371
train/images49_png_jpg.rf.4ae314b2f5d321124e77f8b8b9f1ee67.jpg,290,134,38860,27504,11356
train/images49_png_jpg.rf.4ae314b2f5d321124e77f8b8b9f1ee67.jpg,174,50,8700,6530,2170
train/images505_png_jpg.rf.763e78d385139ca43850a723addb9ee3.jpg,116,118,13688,8290,5398
train/images505_png_jpg.rf.97a956068975e0a88a4955ea946b4f23.jpg,88,109,9592,6343,3249
train/images505_png_jpg.rf.c48c64bbaa31e60ceb3efdff745e0fe0.jpg,82,150,12300,7966,4334
train/images505_png_jpg.rf.c48c64bbaa31e60ceb3efdff745e0fe0.jpg,109,111,12099,8048,4051
train/images506_png_jpg.rf.3ca964d0a8b68e870070d5f6cff929de.jpg,43,82,3526,2781,745
train/images508_png_jpg.rf.8c4378fd6d261011209ab2b0685d08be.jpg,104,94,9776,5550,4226
train/images508_png_jpg.rf.8c4378fd6d261011209ab2b0685d08be.jpg,96,157,15072,8706,6366
train/images508_png_jpg.rf.a7e5d2a2407742e9682bf8b3656d54d6.jpg,96,88,8448,5266,3182
train/images508_png_jpg.rf.a7e5d2a2407742e9682bf8b3656d54d6.jpg,97,155,15035,8577,6458
train/images508_png_jpg.rf.eb517eddd657c9e92201e51cbfd60601.jpg,105,103,10815,5824,4991
train/images508_png_jpg.rf.eb517eddd657c9e92201e51cbfd60601.jpg,96,151,14496,9092,5404
train/images50_png_jpg.rf.5d2aacd87c07a8de2e165bd2c4f8821c.jpg,174,47,8178,6129,2049
train/images50_png_jpg.rf.5d2aacd87c07a8de2e165bd2c4f8821c.jpg,56,63,3528,2448,1080
train/images50_png_jpg.rf.709a5d4bd8c66b0af8c4e6d3246cb405.jpg,186,41,7626,5459,2167
train/images50_png_jpg.rf.de313624c9f901f8d3277d011b3dcaf2.jpg,180,36,6480,4526,1954
train/images510_png_jpg.rf.06251b91fca7760d109c866d56a1b21d.jpg,125,139,17375,13309,4066
train/images510_png_jpg.rf.06251b91fca7760d109c866d56a1b21d.jpg,144,142,20448,13806,6642
train/images510_png_jpg.rf.c6e25426dbf943a6ff93ad940b29e5c7.jpg,78,135,10530,8318,2212
train/images510_png_jpg.rf.c6e25426dbf943a6ff93ad940b29e5c7.jpg,98,141,13818,9959,3859
train/images510_png_jpg.rf.c9c2c98a87ef20a2554f1ae72f22f7df.jpg,105,132,13860,11178,2682
train/images510_png_jpg.rf.c9c2c98a87ef20a2554f1ae72f22f7df.jpg,123,131,16113,11701,4412
train/images511_png_jpg.rf.2fa2072eefb8e7b4365e1a9ffb537ad8.jpg,130,138,17940,14104,3836
train/images511_png_jpg.rf.2fa2072eefb8e7b4365e1a9ffb537ad8.jpg,134,143,19162,14105,5057
train/images511_png_jpg.rf.afb02b2d491315f38e21b53615ce9e48.jpg,128,138,17664,13833,3831
train/images511_png_jpg.rf.afb02b2d491315f38e21b53615ce9e48.jpg,145,143,20735,14873,5862
train/images512_png_jpg.rf.1db7dee1f1adaf82f5956a99c546e7fb.jpg,141,143,20163,15340,4823
train/images512_png_jpg.rf.1db7dee1f1adaf82f5956a99c546e7fb.jpg,161,147,23667,15702,7965
train/images512_png_jpg.rf.b83d0f4e6ab54932cc9f70439dd257e4.jpg,148,150,22200,16660,5540
train/images512_png_jpg.rf.b83d0f4e6ab54932cc9f70439dd257e4.jpg,158,153,24174,17153,7021
train/images512_png_jpg.rf.eec6f8af12b3ba0a375368b08451b6b6.jpg,147,150,22050,16663,5387
train/images512_png_jpg.rf.eec6f8af12b3ba0a375368b08451b6b6.jpg,149,149,22201,16205,5996
train/images513_png_jpg.rf.580cc880f959ad3c582513b0f6ea3721.jpg,192,164,31488,21208,10280
train/images513_png_jpg.rf.580cc880f959ad3c582513b0f6ea3721.jpg,169,158,26702,20589,6113
train/images513_png_jpg.rf.87ad2d15b87e6cf38c593b625360f88b.jpg,163,158,25754,19431,6323
train/images513_png_jpg.rf.87ad2d15b87e6cf38c593b625360f88b.jpg,195,161,31395,20640,10755
train/images513_png_jpg.rf.ff659102c8d3d753c96117e3db490644.jpg,163,158,25754,19248,6506
train/images513_png_jpg.rf.ff659102c8d3d753c96117e3db490644.jpg,182,156,28392,18944,9448
train/images514_png_jpg.rf.88acbf376992241d098d2ad53b626e40.jpg,190,168,31920,23408,8512
train/images514_png_jpg.rf.88acbf376992241d098d2ad53b626e40.jpg,254,175,44450,29359,15091
train/images514_png_jpg.rf.89b8873acfa8c6bdc4701f342ea48f88.jpg,181,164,29684,22169,7515
train/images514_png_jpg.rf.89b8873acfa8c6bdc4701f342ea48f88.jpg,261,166,43326,27524,15802
train/images515_png_jpg.rf.432d72515c21ad65e3452bb5ce956a05.jpg,196,176,34496,27384,7112
train/images515_png_jpg.rf.432d72515c21ad65e3452bb5ce956a05.jpg,208,189,39312,28970,10342
train/images515_png_jpg.rf.4ec0a52043a042d7c838ae027ba1e74b.jpg,247,181,44707,32032,12675
train/images515_png_jpg.rf.4ec0a52043a042d7c838ae027ba1e74b.jpg,208,180,37440,27023,10417
train/images515_png_jpg.rf.69a2f723b714ac2cbb9a9552b8afd53e.jpg,202,176,35552,26588,8964
train/images515_png_jpg.rf.69a2f723b714ac2cbb9a9552b8afd53e.jpg,268,180,48240,31862,16378
train/images516_png_jpg.rf.2e907dcc5795582991e3232219166390.jpg,218,186,40548,31411,9137
train/images516_png_jpg.rf.2e907dcc5795582991e3232219166390.jpg,228,200,45600,33838,11762
train/images516_png_jpg.rf.65843345329b957f93956e9792b26147.jpg,215,202,43430,32131,11299
train/images516_png_jpg.rf.65843345329b957f93956e9792b26147.jpg,198,199,39402,31098,8304
train/images516_png_jpg.rf.aff1acc934cb6883e42edad02bb0747c.jpg,223,195,43485,32267,11218
train/images516_png_jpg.rf.aff1acc934cb6883e42edad02bb0747c.jpg,212,187,39644,30860,8784
train/images517_png_jpg.rf.39468f1846d0c61c7dca03efbdf0519d.jpg,30,104,3120,2533,587
train/images52_png_jpg.rf.135c6249286cd4d010efc1d13f17e354.jpg,68,90,6120,4181,1939
train/images52_png_jpg.rf.f9fe1a4c74655aa5c1924f2f0df45ca6.jpg,53,63,3339,2741,598
train/images530_png_jpg.rf.38279ea514d30733890d82ab3b33458e.jpg,37,142,5254,3640,1614
train/images531_png_jpg.rf.8008933e96580f198e6e745deb13076a.jpg,133,105,13965,9112,4853
train/images531_png_jpg.rf.8008933e96580f198e6e745deb13076a.jpg,123,97,11931,9102,2829
train/images531_png_jpg.rf.e44e15c91f310e32f029622fdcf2fef3.jpg,140,111,15540,9881,5659
train/images531_png_jpg.rf.e44e15c91f310e32f029622fdcf2fef3.jpg,130,104,13520,10297,3223
train/images539_png_jpg.rf.ab859ecf64bdba7bf5078048221897a0.jpg,20,27,540,399,141
train/images53_png_jpg.rf.66d1642781f69a027281b565fc1d88b4.jpg,131,117,15327,10616,4711
train/images53_png_jpg.rf.66d1642781f69a027281b565fc1d88b4.jpg,44,26,1144,798,346
train/images53_png_jpg.rf.a43f96d18e10de3f386e4e0f4cf0b0eb.jpg,118,67,7906,5224,2682
train/images53_png_jpg.rf.a43f96d18e10de3f386e4e0f4cf0b0eb.jpg,210,231,48510,24677,23833
train/images53_png_jpg.rf.e5a44c73224f8d5efe157714af1c2102.jpg,188,245,46060,20835,25225
train/images543_png_jpg.rf.1e15dcb234d6057734bfbe950459d554.jpg,107,165,17655,13405,4250
train/images543_png_jpg.rf.4a1cd505156cf72d7d8400b0d8697cbb.jpg,111,165,18315,14884,3431
train/images543_png_jpg.rf.9979f2ec19e44bd1005a3450fcb74ad0.jpg,65,167,10855,8828,2027
train/images545_png_jpg.rf.ec6f3a124a428c15d64b8a450fa7bed4.jpg,38,162,6156,5011,1145
train/images506_png_jpg.rf.4d53147f26157bad7c8c79f777f04192.jpg,38,78,2964,2317,647
train/images511_png_jpg.rf.2dfa2a376eaa3c86e8af7e87536b00ec.jpg,135,146,19710,15400,4310
train/images511_png_jpg.rf.2dfa2a376eaa3c86e8af7e87536b00ec.jpg,163,147,23961,15665,8296
train/images514_png_jpg.rf.eb8802b460ded49dcfe7c21f7b490a85.jpg,187,172,32164,24096,8068
train/images514_png_jpg.rf.eb8802b460ded49dcfe7c21f7b490a85.jpg,284,181,51404,31752,19652
train/images531_png_jpg.rf.178b23742a0469069b64825ebfa78d41.jpg,136,105,14280,9445,4835
train/images531_png_jpg.rf.178b23742a0469069b64825ebfa78d41.jpg,123,103,12669,9843,2826
train/images558_png_jpg.rf.49213fa5fa69dcda811cd5b1029fd5b0.jpg,60,85,5100,4089,1011
train/images558_png_jpg.rf.49213fa5fa69dcda811cd5b1029fd5b0.jpg,66,84,5544,3001,2543
train/images664_png_jpg.rf.3749b9c120b48d9fd9efdf06ab624ddc.jpg,115,99,11385,7306,4079
train/images664_png_jpg.rf.3749b9c120b48d9fd9efdf06ab624ddc.jpg,104,90,9360,4593,4767
train/images664_png_jpg.rf.b5546f8b02147e4fa83e8c9c103a40c7.jpg,119,100,11900,7559,4341
train/images664_png_jpg.rf.b5546f8b02147e4fa83e8c9c103a40c7.jpg,105,91,9555,5829,3726
train/images664_png_jpg.rf.c434ce70680868599eaab3b34e8fdae8.jpg,123,103,12669,8184,4485
train/images664_png_jpg.rf.c434ce70680868599eaab3b34e8fdae8.jpg,111,98,10878,4674,6204
train/images676_png_jpg.rf.25f64d110d6245fc84b762b90b290287.jpg,53,160,8480,6025,2455
train/images676_png_jpg.rf.ab85542469ec2c88179167c3a41abaa4.jpg,44,160,7040,4801,2239
train/images677_png_jpg.rf.8e35686875e3891098f930fb965e08e3.jpg,45,156,7020,4766,2254
train/images678_png_jpg.rf.78788bb9bd15958054c829e92b8019dd.jpg,51,161,8211,5613,2598
train/images678_png_jpg.rf.aa91bedcba124583234031fbcd50f1f7.jpg,42,157,6594,4286,2308
train/images678_png_jpg.rf.ec70ce289f56cf23eb7dbed886524560.jpg,56,172,9632,6858,2774
train/images679_png_jpg.rf.eb3fe270f971d6e8e3107cc359e8597a.jpg,70,177,12390,9148,3242
train/images679_png_jpg.rf.f99c8cfd4601b6efab28ed3d712f53bc.jpg,71,177,12567,9504,3063
train/images679_png_jpg.rf.fdc42a38e3ec03723e54e5967950002c.jpg,59,156,9204,6963,2241
train/images680_png_jpg.rf.120b6029b84e9463b1b211ecff462e9e.jpg,54,164,8856,6529,2327
train/images680_png_jpg.rf.a929f777701fcebcee2a966d28d1544f.jpg,54,170,9180,6481,2699
train/images680_png_jpg.rf.f144cc0ee77d43f7a149a709e77bc7d9.jpg,59,166,9794,7755,2039
train/images682_png_jpg.rf.ad5ca95f37e3ff9aa5b9ddb1cc68a834.jpg,74,185,13690,10108,3582
train/images682_png_jpg.rf.d5e20b37d2dfda018f642320dfe95ee6.jpg,98,180,17640,12970,4670
train/images684_png_jpg.rf.0c8623592dd5258356bcf500dfcdfb04.jpg,109,194,21146,16100,5046
train/images684_png_jpg.rf.8426efbf26a5bd4806769496e2b3f3a1.jpg,112,198,22176,16105,6071
train/images684_png_jpg.rf.8426efbf26a5bd4806769496e2b3f3a1.jpg,42,156,6552,3806,2746
train/images684_png_jpg.rf.e92d6e1ca88f0df854e7be63434c5b50.jpg,111,194,21534,16104,5430
train/images685_png_jpg.rf.2fa451c2654dc88826e7d3bcf356b113.jpg,120,110,13200,9392,3808
train/images685_png_jpg.rf.2fa451c2654dc88826e7d3bcf356b113.jpg,118,104,12272,5565,6707
train/images685_png_jpg.rf.8ba56fefda76f8635c211cf478070bec.jpg,135,109,14715,9589,5126
train/images685_png_jpg.rf.8ba56fefda76f8635c211cf478070bec.jpg,119,107,12733,4935,7798
train/images685_png_jpg.rf.dd28e53c378b7dccb1ade4859eea426c.jpg,130,105,13650,8763,4887
train/images685_png_jpg.rf.dd28e53c378b7dccb1ade4859eea426c.jpg,120,109,13080,9477,3603
train/images686_png_jpg.rf.3c075e32282d1e5adc6b344c1cb48850.jpg,113,193,21809,16291,5518
train/images686_png_jpg.rf.3c075e32282d1e5adc6b344c1cb48850.jpg,54,185,9990,5786,4204
train/images686_png_jpg.rf.7ca93739093ca478eb51e42c452aa0c6.jpg,95,200,19000,14594,4406
train/images686_png_jpg.rf.ffac50b92fb73395040d12a9f824dedd.jpg,108,186,20088,14873,5215
train/images687_png_jpg.rf.4dc6b04f84258eb32f89a75ba16171dc.jpg,104,194,20176,15324,4852
train/images687_png_jpg.rf.ffd68a8dbc900d0bb6ea73219f21b809.jpg,122,206,25132,17925,7207
train/images687_png_jpg.rf.ffd68a8dbc900d0bb6ea73219f21b809.jpg,50,172,8600,5297,3303
train/images691_png_jpg.rf.1848063ddd78fb0db07eb337d8daa96f.jpg,141,220,31020,22277,8743
train/images691_png_jpg.rf.6ef482e449c869966a1d33b3d41025f3.jpg,140,220,30800,22132,8668
train/images691_png_jpg.rf.6ef482e449c869966a1d33b3d41025f3.jpg,60,194,11640,6780,4860
train/images691_png_jpg.rf.7cbc9a1bf020dc0657ed928c094cc7c2.jpg,132,215,28380,20890,7490
train/images691_png_jpg.rf.7cbc9a1bf020dc0657ed928c094cc7c2.jpg,82,207,16974,10870,6104
train/images694_png_jpg.rf.10c62d692b7e2a170072b03897530055.jpg,158,232,36656,25571,11085
train/images694_png_jpg.rf.10c62d692b7e2a170072b03897530055.jpg,68,203,13804,8107,5697
train/images694_png_jpg.rf.66bd499d22524572d709f96a734f43e2.jpg,164,243,39852,27838,12014
train/images694_png_jpg.rf.66bd499d22524572d709f96a734f43e2.jpg,85,217,18445,12424,6021
train/images694_png_jpg.rf.cf394841825d46889485e66482b4e4bf.jpg,152,230,34960,25084,9876
train/images694_png_jpg.rf.cf394841825d46889485e66482b4e4bf.jpg,101,211,21311,14414,6897
train/images696_png_jpg.rf.9350d197ea8193560648c08bd7d71125.jpg,149,109,16241,10122,6119
train/images696_png_jpg.rf.9350d197ea8193560648c08bd7d71125.jpg,137,101,13837,10761,3076
train/images696_png_jpg.rf.e6404072393a3864632bcc3c386f3d44.jpg,147,103,15141,9977,5164
train/images696_png_jpg.rf.e6404072393a3864632bcc3c386f3d44.jpg,131,114,14934,6111,8823
train/images6_png_jpg.rf.2d39e2fc314b8d6619980dc73a4702c9.jpg,168,241,40488,29919,10569
train/images708_png_jpg.rf.277c146fcdfc9c9a478a4df2926cbb37.jpg,157,109,17113,11364,5749
train/images708_png_jpg.rf.277c146fcdfc9c9a478a4df2926cbb37.jpg,143,124,17732,7621,10111
train/images708_png_jpg.rf.371d5bbf40661c8b0f1c45d38d997f33.jpg,156,112,17472,11432,6040
train/images708_png_jpg.rf.371d5bbf40661c8b0f1c45d38d997f33.jpg,141,104,14664,11551,3113
train/images708_png_jpg.rf.acc6a3c83819695116b8d12edf1baf66.jpg,162,111,17982,12055,5927
train/images708_png_jpg.rf.acc6a3c83819695116b8d12edf1baf66.jpg,145,134,19430,7701,11729
train/images717_png_jpg.rf.247c8da4b417997b7adf036cc25eb75c.jpg,41,106,4346,2657,1689
train/images717_png_jpg.rf.247c8da4b417997b7adf036cc25eb75c.jpg,31,129,3999,2858,1141
train/images717_png_jpg.rf.d1b801165544fb69fb9c9062e02deb45.jpg,35,106,3710,2242,1468
train/images718_png_jpg.rf.b5ad3186a2849f9acb63d281d5481076.jpg,148,125,18500,13997,4503
train/images718_png_jpg.rf.b5ad3186a2849f9acb63d281d5481076.jpg,165,108,17820,11071,6749
train/images718_png_jpg.rf.fc0aeaa4fd4bea1b97e4ae9aee2b60b5.jpg,169,110,18590,12283,6307
train/images718_png_jpg.rf.fc0aeaa4fd4bea1b97e4ae9aee2b60b5.jpg,151,126,19026,7288,11738
train/images719_png_jpg.rf.2684961d8bd00c3836c384a89054baa9.jpg,55,105,5775,4335,1440
train/images719_png_jpg.rf.2684961d8bd00c3836c384a89054baa9.jpg,46,131,6026,4499,1527
train/images719_png_jpg.rf.3df6e6ca9d81b0ac010b45262f1621a5.jpg,34,132,4488,2885,1603
train/images719_png_jpg.rf.3df6e6ca9d81b0ac010b45262f1621a5.jpg,43,106,4558,2825,1733
train/images719_png_jpg.rf.fff2b1ee15bb0f0618a7d08f779ebf19.jpg,81,119,9639,6875,2764
train/images719_png_jpg.rf.fff2b1ee15bb0f0618a7d08f779ebf19.jpg,69,138,9522,7356,2166
train/images720_png_jpg.rf.451acacf731cff8aef9dae8155a80884.jpg,34,143,4862,3129,1733
train/images720_png_jpg.rf.451acacf731cff8aef9dae8155a80884.jpg,45,87,3915,2649,1266
train/images720_png_jpg.rf.4d117fd559f50e5a63158412848f52b9.jpg,76,135,10260,8083,2177
train/images720_png_jpg.rf.4d117fd559f50e5a63158412848f52b9.jpg,86,125,10750,7551,3199
train/images720_png_jpg.rf.6f17f8750471b547adbb533397436bbd.jpg,41,138,5658,4285,1373
train/images720_png_jpg.rf.6f17f8750471b547adbb533397436bbd.jpg,54,112,6048,4090,1958
train/images721_png_jpg.rf.7a9c68b257d8a9c61e182c749a4e673c.jpg,76,128,9728,7847,1881
train/images721_png_jpg.rf.7a9c68b257d8a9c61e182c749a4e673c.jpg,87,122,10614,7423,3191
train/images721_png_jpg.rf.8007a155748cb1f588afd426584618e6.jpg,72,138,9936,8036,1900
train/images721_png_jpg.rf.8007a155748cb1f588afd426584618e6.jpg,84,124,10416,7324,3092
train/images722_png_jpg.rf.363fecd6da689e1d6a73b30b5ebf03fc.jpg,66,120,7920,5673,2247
train/images722_png_jpg.rf.363fecd6da689e1d6a73b30b5ebf03fc.jpg,63,131,8253,6479,1774
train/images722_png_jpg.rf.7f4cdc6d04e227145f7c82653fe16d4b.jpg,58,133,7714,6125,1589
train/images722_png_jpg.rf.7f4cdc6d04e227145f7c82653fe16d4b.jpg,67,114,7638,5475,2163
train/images722_png_jpg.rf.ca0627c5f5e84c3da8789948c4c8c9f7.jpg,96,136,13056,9457,3599
train/images722_png_jpg.rf.ca0627c5f5e84c3da8789948c4c8c9f7.jpg,104,129,13416,8968,4448
train/images723_png_jpg.rf.4e480ccc67344f9056678b1aa4aad3e2.jpg,104,137,14248,10674,3574
train/images723_png_jpg.rf.4e480ccc67344f9056678b1aa4aad3e2.jpg,115,132,15180,10524,4656
train/images723_png_jpg.rf.7241185e3f235b91c74f55d09625845e.jpg,105,133,13965,10139,3826
train/images723_png_jpg.rf.7241185e3f235b91c74f55d09625845e.jpg,115,129,14835,10188,4647
train/images723_png_jpg.rf.748132fefb9c4b03b5b2920cd24d5abd.jpg,66,139,9174,7140,2034
train/images723_png_jpg.rf.748132fefb9c4b03b5b2920cd24d5abd.jpg,77,125,9625,6654,2971
train/images724_png_jpg.rf.876ada9f8cd9ff0d92fe833d9f2a8c7c.jpg,114,142,16188,11697,4491
train/images724_png_jpg.rf.876ada9f8cd9ff0d92fe833d9f2a8c7c.jpg,130,136,17680,11861,5819
train/images724_png_jpg.rf.997dc74c00cd0c61768fb1fd86619f67.jpg,68,150,10200,8110,2090
train/images724_png_jpg.rf.997dc74c00cd0c61768fb1fd86619f67.jpg,74,126,9324,7302,2022
train/images724_png_jpg.rf.e33b87aa2e8aa7fe3275cb3027612136.jpg,102,145,14790,11189,3601
train/images724_png_jpg.rf.e33b87aa2e8aa7fe3275cb3027612136.jpg,107,142,15194,10140,5054
train/images725_png_jpg.rf.28db67630905969915908189725f3cb8.jpg,140,142,19880,12984,6896
train/images725_png_jpg.rf.28db67630905969915908189725f3cb8.jpg,124,144,17856,13037,4819
train/images677_png_jpg.rf.f9ebfcc03ceaa3754d339850cee0ee72.jpg,42,158,6636,4293,2343
train/images682_png_jpg.rf.c9070ae967579e72ddda38a5ca9bdcdc.jpg,78,184,14352,11124,3228
train/images687_png_jpg.rf.226ebf5bad9c1460b86992055a6b521e.jpg,114,192,21888,16229,5659
train/images696_png_jpg.rf.fedc82e8893db2993fd5d3af692946ff.jpg,133,116,15428,11467,3961
train/images696_png_jpg.rf.fedc82e8893db2993fd5d3af692946ff.jpg,143,104,14872,9070,5802
train/images718_png_jpg.rf.4db45fc533fba6356af9e28b303de8de.jpg,169,113,19097,12540,6557
train/images718_png_jpg.rf.4db45fc533fba6356af9e28b303de8de.jpg,151,110,16610,13256,3354
train/images721_png_jpg.rf.f0bcd926806d7adb4d6ce934d9c6f812.jpg,79,121,9559,6372,3187
train/images721_png_jpg.rf.f0bcd926806d7adb4d6ce934d9c6f812.jpg,67,132,8844,6685,2159
train/images725_png_jpg.rf.f3e260e68f9a02bffbe23d6cedbc731a.jpg,159,151,24009,15827,8182
train/images725_png_jpg.rf.f3e260e68f9a02bffbe23d6cedbc731a.jpg,137,163,22331,15775,6556
train/images726_png_jpg.rf.005d3dda57d2f0e8dc5a484abc951928.jpg,123,159,19557,14247,5310
train/images726_png_jpg.rf.005d3dda57d2f0e8dc5a484abc951928.jpg,139,150,20850,13892,6958
train/images726_png_jpg.rf.2141a6f63744576f0fd898adeb68d19a.jpg,169,151,25519,16191,9328
train/images726_png_jpg.rf.2141a6f63744576f0fd898adeb68d19a.jpg,139,171,23769,16428,7341
train/images726_png_jpg.rf.8a1bf419e6d3cd9d0b6be8b9356b3c32.jpg,161,143,23023,14632,8391
train/images726_png_jpg.rf.8a1bf419e6d3cd9d0b6be8b9356b3c32.jpg,130,151,19630,14046,5584
train/images727_png_jpg.rf.05c0c53d7f34c16c0bc6666e3a53c2e1.jpg,151,161,24311,16220,8091
train/images727_png_jpg.rf.05c0c53d7f34c16c0bc6666e3a53c2e1.jpg,138,170,23460,16419,7041
train/images727_png_jpg.rf.f256933a83c1fd0504f04f7842dfbec9.jpg,178,154,27412,17163,10249
train/images727_png_jpg.rf.f256933a83c1fd0504f04f7842dfbec9.jpg,148,164,24272,17117,7155
train/images727_png_jpg.rf.fc12e3aa566c1e33dfdadaf57906ec26.jpg,168,155,26040,17054,8986
train/images727_png_jpg.rf.fc12e3aa566c1e33dfdadaf57906ec26.jpg,143,168,24024,16974,7050
train/images729_png_jpg.rf.309ef7d69c0dc35bd50d1a4f4505e84d.jpg,178,117,20826,13559,7267
train/images729_png_jpg.rf.309ef7d69c0dc35bd50d1a4f4505e84d.jpg,162,126,20412,15554,4858
train/images729_png_jpg.rf.9b589ba5cd34ecb1186d161463fe3fc8.jpg,175,115,20125,13463,6662
train/images729_png_jpg.rf.9b589ba5cd34ecb1186d161463fe3fc8.jpg,159,121,19239,14908,4331
train/images729_png_jpg.rf.a2ee3a1b2215e4f29fd8e0c15192f0e1.jpg,179,118,21122,13950,7172
train/images729_png_jpg.rf.a2ee3a1b2215e4f29fd8e0c15192f0e1.jpg,162,126,20412,15749,4663
train/images730_png_jpg.rf.581c27729141e548f5507d94edfaa1a5.jpg,206,178,36668,22859,13809
train/images730_png_jpg.rf.581c27729141e548f5507d94edfaa1a5.jpg,174,192,33408,22795,10613
train/images730_png_jpg.rf.799817c2b59a6715eb4672e1fe6e5832.jpg,207,179,37053,23301,13752
train/images730_png_jpg.rf.799817c2b59a6715eb4672e1fe6e5832.jpg,181,188,34028,22744,11284
train/images731_png_jpg.rf.02767c01bb59b93fa9b02c36b3a77c0c.jpg,216,178,38448,23944,14504
train/images731_png_jpg.rf.02767c01bb59b93fa9b02c36b3a77c0c.jpg,184,189,34776,23539,11237
train/images731_png_jpg.rf.29a8d41b1fa343d8106f8878a3bc1423.jpg,216,182,39312,24690,14622
train/images731_png_jpg.rf.29a8d41b1fa343d8106f8878a3bc1423.jpg,175,190,33250,23308,9942
train/images731_png_jpg.rf.e19d97cfcbad4ea00685e4e79e4ab07f.jpg,212,180,38160,23964,14196
train/images731_png_jpg.rf.e19d97cfcbad4ea00685e4e79e4ab07f.jpg,180,188,33840,24343,9497
train/images732_png_jpg.rf.16b7356de50a39d585fc362d34458cc5.jpg,191,191,36481,24785,11696
train/images732_png_jpg.rf.16b7356de50a39d585fc362d34458cc5.jpg,225,186,41850,25307,16543
train/images732_png_jpg.rf.bd727219144d17f0723ff9abbe90b6cd.jpg,235,184,43240,27268,15972
train/images732_png_jpg.rf.bd727219144d17f0723ff9abbe90b6cd.jpg,206,205,42230,27097,15133
train/images732_png_jpg.rf.dc0492fc7f75670d2e2192980a3daf7e.jpg,230,185,42550,26441,16109
train/images732_png_jpg.rf.dc0492fc7f75670d2e2192980a3daf7e.jpg,193,196,37828,25763,12065
train/images733_png_jpg.rf.728da732d4f6b0bf8c0399c4e25d7646.jpg,249,191,47559,28915,18644
train/images733_png_jpg.rf.728da732d4f6b0bf8c0399c4e25d7646.jpg,202,192,38784,26592,12192
train/images733_png_jpg.rf.791e3f9891c635a4d155f5aa24793f5a.jpg,233,185,43105,26298,16807
train/images733_png_jpg.rf.791e3f9891c635a4d155f5aa24793f5a.jpg,192,189,36288,24106,12182
train/images735_png_jpg.rf.1b90d9c7418826a1986507505ab3b15f.jpg,217,209,45353,30808,14545
train/images735_png_jpg.rf.1b90d9c7418826a1986507505ab3b15f.jpg,196,212,41552,31194,10358
train/images735_png_jpg.rf.1e09a1313f70c4a011bec3bbab92e71e.jpg,227,214,48578,33047,15531
train/images735_png_jpg.rf.1e09a1313f70c4a011bec3bbab92e71e.jpg,208,216,44928,30170,14758
train/images735_png_jpg.rf.4add67762b71bf91a30ecf6412fa228b.jpg,219,201,44019,31794,12225
train/images735_png_jpg.rf.4add67762b71bf91a30ecf6412fa228b.jpg,249,216,53784,35306,18478
train/images736_png_jpg.rf.1b28ce92afbefd2d7b3b5f700462aef5.jpg,159,239,38001,26243,11758
train/images736_png_jpg.rf.1b28ce92afbefd2d7b3b5f700462aef5.jpg,190,226,42940,26917,16023
train/images736_png_jpg.rf.3aa47fbddd6bce92cd242bccc066483a.jpg,235,218,51230,34262,16968
train/images736_png_jpg.rf.3aa47fbddd6bce92cd242bccc066483a.jpg,205,237,48585,36083,12502
train/images736_png_jpg.rf.7cd8f213edba07570f06d88397155514.jpg,190,229,43510,31172,12338
train/images736_png_jpg.rf.7cd8f213edba07570f06d88397155514.jpg,218,218,47524,31029,16495
train/images737_png_jpg.rf.6f1cd744be7a6567120726bda97155b8.jpg,201,238,47838,35349,12489
train/images737_png_jpg.rf.6f1cd744be7a6567120726bda97155b8.jpg,232,235,54520,35492,19028
train/images737_png_jpg.rf.ca4fa28ac94945b1b66e52558b1b6ddb.jpg,229,217,49693,33671,16022
train/images737_png_jpg.rf.ca4fa28ac94945b1b66e52558b1b6ddb.jpg,199,235,46765,34854,11911
train/images737_png_jpg.rf.ee3458833bf0dde2ccd5e529318c0b27.jpg,188,228,42864,31479,11385
train/images737_png_jpg.rf.ee3458833bf0dde2ccd5e529318c0b27.jpg,219,229,50151,31510,18641
train/images738_png_jpg.rf.719e3d93d1ab157f60ab19b00d7912dd.jpg,113,222,25086,15709,9377
train/images738_png_jpg.rf.719e3d93d1ab157f60ab19b00d7912dd.jpg,155,197,30535,19576,10959
train/images738_png_jpg.rf.da5e869b26e83e592f0bbcf4c48e81d3.jpg,164,241,39524,26687,12837
train/images738_png_jpg.rf.da5e869b26e83e592f0bbcf4c48e81d3.jpg,203,229,46487,28389,18098
train/images739_png_jpg.rf.508bc2cf36a589e8d765b572c4398027.jpg,183,116,21228,14186,7042
train/images739_png_jpg.rf.508bc2cf36a589e8d765b572c4398027.jpg,161,120,19320,15264,4056
train/images739_png_jpg.rf.e593959425bbd0d7983654d55bd111d2.jpg,183,115,21045,13791,7254
train/images739_png_jpg.rf.e593959425bbd0d7983654d55bd111d2.jpg,166,121,20086,15637,4449
train/images739_png_jpg.rf.e718a6db70dc98f5ab50e726beca5d0c.jpg,170,139,23630,18532,5098
train/images739_png_jpg.rf.e718a6db70dc98f5ab50e726beca5d0c.jpg,193,116,22388,14205,8183
train/images740_png_jpg.rf.067facf109e0a3f0dd38869ed7827840.jpg,168,206,34608,21887,12721
train/images740_png_jpg.rf.067facf109e0a3f0dd38869ed7827840.jpg,126,230,28980,18835,10145
train/images740_png_jpg.rf.654929ccab669e7c374ea7dca86b22d5.jpg,155,180,27900,18859,9041
train/images740_png_jpg.rf.654929ccab669e7c374ea7dca86b22d5.jpg,111,211,23421,14687,8734
train/images740_png_jpg.rf.d688c8ca6dd912da993e18dffa665956.jpg,184,217,39928,24510,15418
train/images740_png_jpg.rf.d688c8ca6dd912da993e18dffa665956.jpg,142,240,34080,21026,13054
train/images741_png_jpg.rf.0fd4d343d0aac081104b3c1e0e0e9074.jpg,116,181,20996,9489,11507
train/images741_png_jpg.rf.0fd4d343d0aac081104b3c1e0e0e9074.jpg,135,193,26055,15860,10195
train/images741_png_jpg.rf.4fb0ba314804a531b45b1206f38bab23.jpg,148,179,26492,17840,8652
train/images741_png_jpg.rf.4fb0ba314804a531b45b1206f38bab23.jpg,121,206,24926,13558,11368
train/images741_png_jpg.rf.fff8569e43fd96a7bd1eff27f182b634.jpg,177,191,33807,23704,10103
train/images741_png_jpg.rf.fff8569e43fd96a7bd1eff27f182b634.jpg,132,230,30360,19547,10813
train/images742_png_jpg.rf.92f23547dd1e65bc11a398d4564746a9.jpg,160,230,36800,19004,17796
train/images742_png_jpg.rf.92f23547dd1e65bc11a398d4564746a9.jpg,177,202,35754,24079,11675
train/images742_png_jpg.rf.f6bc5379178c10ce3dd913ff2da6cfa6.jpg,151,194,29294,18772,10522
train/images742_png_jpg.rf.f6bc5379178c10ce3dd913ff2da6cfa6.jpg,128,199,25472,12694,12778
train/images743_png_jpg.rf.2e5d6ff36319090a9306019a8b011350.jpg,116,180,20880,9122,11758
train/images743_png_jpg.rf.2e5d6ff36319090a9306019a8b011350.jpg,140,208,29120,16584,12536
train/images743_png_jpg.rf.71dca94ecd634c470fb0cf55b6b15486.jpg,166,211,35026,22642,12384
train/images743_png_jpg.rf.71dca94ecd634c470fb0cf55b6b15486.jpg,151,202,30502,15034,15468
train/images743_png_jpg.rf.b00363832fb48565e5ad49dc4e86969f.jpg,111,187,20757,10390,10367
train/images743_png_jpg.rf.b00363832fb48565e5ad49dc4e86969f.jpg,89,136,12104,5199,6905
train/images750_png_jpg.rf.176da530fb8798ee4e147c18eec05867.jpg,191,118,22538,15757,6781
train/images750_png_jpg.rf.176da530fb8798ee4e147c18eec05867.jpg,171,126,21546,16868,4678
train/images750_png_jpg.rf.3f60a7e63cfd59ee0797713c39144313.jpg,208,126,26208,17380,8828
train/images750_png_jpg.rf.3f60a7e63cfd59ee0797713c39144313.jpg,186,132,24552,19185,5367
train/images750_png_jpg.rf.689a9ddddb4a6270273cc4cf079cd967.jpg,178,142,25276,18392,6884
train/images750_png_jpg.rf.689a9ddddb4a6270273cc4cf079cd967.jpg,200,117,23400,14892,8508
train/images75_png_jpg.rf.dca0da7837c3125a2ed900810096486b.jpg,55,137,7535,5554,1981
train/images760_png_jpg.rf.669fda24ed2b73b466013c5167e86027.jpg,210,120,25200,17079,8121
train/images760_png_jpg.rf.669fda24ed2b73b466013c5167e86027.jpg,189,130,24570,18903,5667
train/images760_png_jpg.rf.7c20e63f3abc4c0b5b17fe11b82dc918.jpg,167,138,23046,16081,6965
train/images760_png_jpg.rf.7c20e63f3abc4c0b5b17fe11b82dc918.jpg,186,120,22320,13332,8988
train/images760_png_jpg.rf.f0448595068cfcb1312d3b04d71cfc91.jpg,168,113,18984,13395,5589
train/images760_png_jpg.rf.f0448595068cfcb1312d3b04d71cfc91.jpg,146,151,22046,14498,7548
train/images761_png_jpg.rf.c0ce09408207605a166d5ff096aba5d1.jpg,99,105,10395,6691,3704
train/images761_png_jpg.rf.c9b8139e8038b2f2858b832cbbbfbe75.jpg,95,108,10260,6967,3293
train/images761_png_jpg.rf.c9b8139e8038b2f2858b832cbbbfbe75.jpg,23,33,759,431,328
train/images762_png_jpg.rf.122fadb19475b7c4a5dd027949b98b9b.jpg,136,117,15912,10784,5128
train/images762_png_jpg.rf.2b7bc985b58bdea23f5e92218fc13ae2.jpg,172,116,19952,12125,7827
train/images762_png_jpg.rf.3e9becfcd21f0b2f911feb7b997d3f0c.jpg,173,124,21452,13252,8200
train/images763_png_jpg.rf.103d7db92ddb461bd64ee7a3596b0023.jpg,240,136,32640,20218,12422
train/images763_png_jpg.rf.815efd826fa0095a060e442872520073.jpg,232,136,31552,18851,12701
train/images763_png_jpg.rf.9f6de710750e48f040a6cc3688dd4274.jpg,223,132,29436,17638,11798
train/images764_png_jpg.rf.983dcb2eab0c730f5b18b87dda4b7bef.jpg,248,164,40672,24734,15938
train/images764_png_jpg.rf.ace634a158fb3186e223e03e97be2ffd.jpg,261,166,43326,27379,15947
train/images764_png_jpg.rf.ec002f5935f3f143b3d3e3e8c9927d43.jpg,180,110,19800,14536,5264
train/images765_png_jpg.rf.33d431d0e105cd6bcf918001b4c3f2f1.jpg,144,95,13680,9252,4428
train/images765_png_jpg.rf.780171ad6ab25e9fa98ad974d8281d7b.jpg,149,94,14006,9854,4152
train/images766_png_jpg.rf.65a16d0324d103e66fbbb047be9907ba.jpg,216,154,33264,24843,8421
train/images766_png_jpg.rf.b6c60d75d196c0309947487e2df8213b.jpg,225,157,35325,26209,9116
train/images766_png_jpg.rf.dc96a0d744a795d4feabf703ac856ed1.jpg,233,162,37746,27750,9996
train/images767_png_jpg.rf.0e1463ac41a409e9fe1449e416dba5a7.jpg,215,153,32895,24174,8721
train/images767_png_jpg.rf.1b5465664c4c9dfbadb0037ee7e44699.jpg,225,159,35775,26213,9562
train/images767_png_jpg.rf.41b38e64f83e3045d39082013aaf5b7d.jpg,233,165,38445,28101,10344
train/images768_png_jpg.rf.4bf8916337d5f5da3f97f66d1c83b686.jpg,210,152,31920,23952,7968
train/images768_png_jpg.rf.5b7f23c5595510ea39d9cb721277708e.jpg,216,154,33264,24516,8748
train/images768_png_jpg.rf.88e2acaeacf66824cf51c1bdb8826f60.jpg,212,152,32224,23899,8325
train/images769_png_jpg.rf.56ef42015820feadd5ee266fed39745f.jpg,204,151,30804,22492,8312
train/images769_png_jpg.rf.7d89925ad876ab6b04e490c9ed47f050.jpg,215,154,33110,24600,8510
train/images76_png_jpg.rf.36e548c4493f387da4d6b3fcc38e6028.jpg,64,57,3648,2996,652
train/images76_png_jpg.rf.4bc1bf46119817dba3c0c31300ae4011.jpg,52,59,3068,2511,557
train/images770_png_jpg.rf.6d498b45bf16521225690962152b52c4.jpg,203,148,30044,22494,7550
train/images770_png_jpg.rf.9ef837a0a51f21742d61b2932d344fab.jpg,216,159,34344,25484,8860
train/images770_png_jpg.rf.e8ba621478bcfcbbd20b8798a43a7895.jpg,208,146,30368,22113,8255
train/images771_png_jpg.rf.7f33465bd7eb9f50d663cf5550a6c750.jpg,225,121,27225,19108,8117
train/images771_png_jpg.rf.7f33465bd7eb9f50d663cf5550a6c750.jpg,201,149,29949,12959,16990
train/images771_png_jpg.rf.b19db6dd417c91cdba48a1a91ca54d31.jpg,175,124,21700,15257,6443
train/images771_png_jpg.rf.b19db6dd417c91cdba48a1a91ca54d31.jpg,153,153,23409,17726,5683
train/images730_png_jpg.rf.3ad1508e49ef29a2686df8d6d402c793.jpg,184,170,31280,20776,10504
train/images730_png_jpg.rf.3ad1508e49ef29a2686df8d6d402c793.jpg,165,169,27885,20073,7812
train/images733_png_jpg.rf.d180d04b88cf9b5271899a45664e89b0.jpg,241,196,47236,28655,18581
train/images733_png_jpg.rf.d180d04b88cf9b5271899a45664e89b0.jpg,195,190,37050,25078,11972
train/images738_png_jpg.rf.9d7a77093cf427af3a78812a4f032eee.jpg,176,216,38016,23733,14283
train/images738_png_jpg.rf.9d7a77093cf427af3a78812a4f032eee.jpg,134,246,32964,22819,10145
train/images742_png_jpg.rf.70e479a02702be3004289905ce36ef32.jpg,155,203,31465,20591,10874
train/images742_png_jpg.rf.70e479a02702be3004289905ce36ef32.jpg,112,195,21840,13023,8817
train/images751_png_jpg.rf.a8c73d63487f01e7d58e03a6134983c6.jpg,175,141,24675,15597,9078
train/images761_png_jpg.rf.f9d634d8e0c8b5339c1b7d7675ef679d.jpg,116,108,12528,8198,4330
train/images765_png_jpg.rf.5a352daca4b20ac8c77f52fe47f43c6d.jpg,175,111,19425,13334,6091
train/images769_png_jpg.rf.2e0510e3973f4601780f0fb38d30f018.jpg,216,159,34344,26001,8343
train/images772_png_jpg.rf.65d5fa8c437e61e30797abee98e22c86.jpg,209,156,32604,24079,8525
train/images772_png_jpg.rf.a6819bce5af7aee273e789d198aacb56.jpg,212,156,33072,24356,8716
train/images772_png_jpg.rf.ac72b3e2dfffe62408139b604a7ff118.jpg,199,147,29253,21561,7692
train/images773_png_jpg.rf.2187b061556aea1c60787f467dc6a444.jpg,190,147,27930,20566,7364
train/images773_png_jpg.rf.3b4dd1075966fdddc553e932e80366d0.jpg,202,151,30502,22880,7622
train/images773_png_jpg.rf.62f7c51c0b4070e18d981b8e24160a5d.jpg,200,150,30000,22408,7592
train/images77_png_jpg.rf.4aecaf5b94a5fbcb85e10b112bb04182.jpg,50,167,8350,5948,2402
train/images77_png_jpg.rf.4aecaf5b94a5fbcb85e10b112bb04182.jpg,79,108,8532,6897,1635
train/images77_png_jpg.rf.de2739783ebf6ec24d730fa83970f4b8.jpg,42,145,6090,4341,1749
train/images77_png_jpg.rf.de2739783ebf6ec24d730fa83970f4b8.jpg,83,106,8798,6992,1806
train/images781_png_jpg.rf.6f9cf637c5ed0fba9071e412e6e5a408.jpg,207,123,25461,18999,6462
train/images781_png_jpg.rf.6f9cf637c5ed0fba9071e412e6e5a408.jpg,186,151,28086,21085,7001
train/images781_png_jpg.rf.c871398ce5e3f94249d656b9d08dd366.jpg,169,120,20280,13991,6289
train/images781_png_jpg.rf.c871398ce5e3f94249d656b9d08dd366.jpg,147,150,22050,16880,5170
train/images78_png_jpg.rf.4bdc4f22eef748c1e663faa69649820a.jpg,66,166,10956,8455,2501
train/images78_png_jpg.rf.98df301f114561b6074c6bf6c11b0a75.jpg,89,161,14329,11496,2833
train/images78_png_jpg.rf.c3f26623772fbcf8279529cebdac339a.jpg,106,161,17066,12987,4079
train/images792_png_jpg.rf.201d0ea33360a74a1f688907fdcbbda5.jpg,163,117,19071,12974,6097
train/images792_png_jpg.rf.201d0ea33360a74a1f688907fdcbbda5.jpg,140,152,21280,9990,11290
train/images792_png_jpg.rf.4fe312434c6930c1533a6d170eda88c1.jpg,170,127,21590,14053,7537
train/images792_png_jpg.rf.4fe312434c6930c1533a6d170eda88c1.jpg,148,160,23680,16565,7115
train/images792_png_jpg.rf.5bfe5ae3a635c3cc1b8eda66b03e607a.jpg,150,127,19050,11962,7088
train/images79_png_jpg.rf.4b49040f328e4e932f2a3e43de8c875b.jpg,87,159,13833,10294,3539
train/images79_png_jpg.rf.51fca45e9915324fab86aede28b5a2c8.jpg,89,160,14240,11165,3075
train/images79_png_jpg.rf.5bdd73d46abdabdf9a561fdd4f55aa0e.jpg,80,168,13440,10299,3141
train/images802_png_jpg.rf.5386a581973faffef154af5650f827f0.jpg,151,122,18422,11724,6698
train/images802_png_jpg.rf.b22b705a9b006858122febb9f9261b02.jpg,142,131,18602,10994,7608
train/images80_png_jpg.rf.448db3e70c5bcd5b83d4b22e09935cbf.jpg,109,222,24198,15624,8574
train/images80_png_jpg.rf.af8bbc2f0c20eacfd0bdd15bd15c4d2f.jpg,133,226,30058,23041,7017
train/images814_png_jpg.rf.04eaddc344ff704d8eee4ebcf9fd4409.jpg,153,134,20502,12211,8291
train/images814_png_jpg.rf.61e97a07b0cb7fb7063084cddbc6f3aa.jpg,93,101,9393,5814,3579
train/images814_png_jpg.rf.61e97a07b0cb7fb7063084cddbc6f3aa.jpg,62,168,10416,6452,3964
train/images814_png_jpg.rf.f0ad3614d0aff5707e756279260f676f.jpg,118,97,11446,7846,3600
train/images814_png_jpg.rf.f0ad3614d0aff5707e756279260f676f.jpg,86,160,13760,9849,3911
train/images824_png_jpg.rf.206b7482c26d86be64b9119c982fd904.jpg,111,104,11544,7569,3975
train/images824_png_jpg.rf.206b7482c26d86be64b9119c982fd904.jpg,77,160,12320,8523,3797
train/images824_png_jpg.rf.4c68371ab56f65a70e1cac4f7966c0bb.jpg,151,119,17969,11814,6155
train/images83_png_jpg.rf.01feeda6b9cea7f7f6393b8b64c604cc.jpg,209,272,56848,42189,14659
train/images83_png_jpg.rf.041cddb47598980ec0d83730cf8d91c8.jpg,189,255,48195,35515,12680
train/images83_png_jpg.rf.c2ab98799133ed93211de42aa6a66303.jpg,203,255,51765,40264,11501
train/images84_png_jpg.rf.8f0588d0e71ff9329cdd34fa33ea9341.jpg,248,271,67208,51317,15891
train/images84_png_jpg.rf.c3ac918ddae580e151595a36acb62a42.jpg,324,278,90072,67869,22203
train/images86_png_jpg.rf.048678b9fffe88bba882f323bc606d46.jpg,325,300,97500,81267,16233
train/images86_png_jpg.rf.3fb01acd4f0fb10738da5ccc84dd5a57.jpg,325,306,99450,87658,11792
train/images86_png_jpg.rf.78633f56f6a6ea8bb84a1621cbacc193.jpg,317,309,97953,81579,16374
train/images923_png_jpg.rf.17df4556c0eb1fdd03bf6ac5f7658b56.jpg,78,220,17160,13907,3253
train/images923_png_jpg.rf.fad121bd07cf848b7f27ae48ce245e53.jpg,104,236,24544,18334,6210
train/images924_png_jpg.rf.0656bc6836ded3f58f21f2621c0166dc.jpg,151,242,36542,26282,10260
train/images924_png_jpg.rf.5b0f7d41a87d3581c64b023fb9d004a4.jpg,113,235,26555,21088,5467
train/images925_png_jpg.rf.1388a55ce31bff0ca6d1264ffcc2c580.jpg,161,240,38640,29200,9440
train/images925_png_jpg.rf.7257d7e3ea18a749cea7fdd105bc7cc5.jpg,152,245,37240,29176,8064
train/images925_png_jpg.rf.73cf98096abea9331a7084e2559980bf.jpg,174,241,41934,30020,11914
train/images926_png_jpg.rf.0032d158e1c38f90fcb8100be30ad85d.jpg,210,255,53550,37603,15947
train/images926_png_jpg.rf.993151691900a6ba2ddc695f79478f1c.jpg,214,257,54998,38711,16287
train/images926_png_jpg.rf.acd3c5749c326aedc4c73081080195e1.jpg,215,240,51600,38863,12737
train/images927_png_jpg.rf.240bbbf67b0da80b36dd3d6f6e71b016.jpg,243,265,64395,50109,14286
train/images927_png_jpg.rf.33adff12ddeafe6c4e0c41a29467f150.jpg,245,270,66150,49242,16908
train/images927_png_jpg.rf.4651f82473bbde291ae8e7e830fe9fb1.jpg,251,288,72288,55422,16866
train/images781_png_jpg.rf.b418f23831f8ee1881ab6579519c7d42.jpg,186,126,23436,16025,7411
train/images781_png_jpg.rf.b418f23831f8ee1881ab6579519c7d42.jpg,164,137,22468,18562,3906
train/images802_png_jpg.rf.32f83c98024dd380894bcabf62d75362.jpg,128,105,13440,8958,4482
train/images802_png_jpg.rf.32f83c98024dd380894bcabf62d75362.jpg,97,173,16781,11143,5638
train/images824_png_jpg.rf.6af0ea15ba5f8c6cab209ecce4e174d6.jpg,140,125,17500,10427,7073
train/images824_png_jpg.rf.6af0ea15ba5f8c6cab209ecce4e174d6.jpg,109,180,19620,13416,6204
train/images84_png_jpg.rf.a666913482701bc10362bf7c9501a641.jpg,243,271,65853,52742,13111
train/images924_png_jpg.rf.371aa3c06594bf86c8383410681901ef.jpg,142,241,34222,24767,9455
train/images928_png_jpg.rf.dfd43c41f4f0b1ac2e3e987d94e8aebb.jpg,230,339,77970,55739,22231
train/images928_png_jpg.rf.f71ed78e2e39140dcfc9bcbce5d9d8de.jpg,201,327,65727,46581,19146
train/images929_png_jpg.rf.0e909fbeaaa9d738d8838f9a86f824dd.jpg,180,339,61020,36871,24149
train/images929_png_jpg.rf.1f3b40f74f74b5cf3462beaf6b8af457.jpg,124,267,33108,21291,11817
train/images929_png_jpg.rf.75960c21ac7218e74a48152e31a84d6e.jpg,174,366,63684,36907,26777
train/images937_png_jpg.rf.01900cd1cc26ff3be852d452ea5ac2fe.jpg,42,165,6930,5805,1125
train/images937_png_jpg.rf.7bbbcaa4b1b9cc7a9d3653c6f52d8dc0.jpg,48,170,8160,6646,1514
train/images937_png_jpg.rf.e4baff35891b6001a97b78b907e5266d.jpg,42,176,7392,5545,1847
train/images938_png_jpg.rf.44d09df0becc9b00711d9bebfa706a5b.jpg,46,177,8142,6504,1638
train/images939_png_jpg.rf.639b64886df54fc1e50a71c03c94a59e.jpg,40,175,7000,5685,1315
train/images939_png_jpg.rf.c5b32dfbf15dda8870da930f675c0604.jpg,32,182,5824,3714,2110
train/images940_png_jpg.rf.4f84145ce1d9988dbc8c48e36675200b.jpg,221,157,34697,26738,7959
train/images940_png_jpg.rf.4f84145ce1d9988dbc8c48e36675200b.jpg,53,196,10388,8181,2207
train/images940_png_jpg.rf.cee731a82b47f7fa755d9e15bfb2eb8d.jpg,83,197,16351,12175,4176
train/images940_png_jpg.rf.cee731a82b47f7fa755d9e15bfb2eb8d.jpg,184,158,29072,21361,7711
train/images940_png_jpg.rf.db6189861dda3a2b1fc78e6737434b3f.jpg,68,195,13260,10962,2298
train/images940_png_jpg.rf.db6189861dda3a2b1fc78e6737434b3f.jpg,207,160,33120,23820,9300
train/images942_png_jpg.rf.0981f8203899a2bf1744c1756ba096e7.jpg,160,167,26720,19636,7084
train/images942_png_jpg.rf.0981f8203899a2bf1744c1756ba096e7.jpg,83,194,16102,12072,4030
train/images942_png_jpg.rf.86d19700347e6312f7abd1bae13420e6.jpg,192,162,31104,23265,7839
train/images942_png_jpg.rf.86d19700347e6312f7abd1bae13420e6.jpg,77,195,15015,12145,2870
train/images943_png_jpg.rf.5b451e8397a19afaeff1e7069be16c0f.jpg,146,181,26426,20401,6025
train/images943_png_jpg.rf.5b451e8397a19afaeff1e7069be16c0f.jpg,102,209,21318,15686,5632
train/images943_png_jpg.rf.8f4248c2b83a5b72f813847b21162094.jpg,135,178,24030,19054,4976
train/images943_png_jpg.rf.8f4248c2b83a5b72f813847b21162094.jpg,100,211,21100,15350,5750
train/images943_png_jpg.rf.fe035ca9ea3c7707d318044ed1d69f74.jpg,98,210,20580,14638,5942
train/images943_png_jpg.rf.fe035ca9ea3c7707d318044ed1d69f74.jpg,114,169,19266,14547,4719
train/images944_png_jpg.rf.19f8eabf88f934ee73aaefd804cbb56f.jpg,116,226,26216,18888,7328
train/images944_png_jpg.rf.19f8eabf88f934ee73aaefd804cbb56f.jpg,118,182,21476,18393,3083
train/images944_png_jpg.rf.550b8f558cda8f8b7fe7dd60064c42d7.jpg,115,238,27370,19689,7681
train/images944_png_jpg.rf.550b8f558cda8f8b7fe7dd60064c42d7.jpg,113,190,21470,15952,5518
train/images944_png_jpg.rf.e2c25241f20c3c8ce1c07f594ef9e2df.jpg,118,230,27140,19389,7751
train/images944_png_jpg.rf.e2c25241f20c3c8ce1c07f594ef9e2df.jpg,26,122,3172,2363,809
train/images945_png_jpg.rf.2ffea9145dcd6bf6c27e824abe671a43.jpg,132,238,31416,22147,9269
train/images945_png_jpg.rf.a05607e57e51f387ab67123186ed267e.jpg,135,250,33750,24029,9721
train/images945_png_jpg.rf.c908f41a25020c7bdf670f286205d330.jpg,128,231,29568,21362,8206
train/images945_png_jpg.rf.c908f41a25020c7bdf670f286205d330.jpg,54,152,8208,6405,1803
train/images946_png_jpg.rf.599bf0cd41baf12f257613214e0be67d.jpg,154,256,39424,27707,11717
train/images946_png_jpg.rf.c229a5ee95a414ecaa957f52fe8e5fd3.jpg,147,250,36750,24824,11926
train/images947_png_jpg.rf.279a6ea007ab1255a515cf1138a4d3cd.jpg,129,287,37023,25300,11723
train/images947_png_jpg.rf.668ab01a7fd56b2550ad72ec4860632e.jpg,173,288,49824,34223,15601
train/images947_png_jpg.rf.d6a57b1201cd5bda6f02cc4f7a50cb52.jpg,167,269,44923,32215,12708
train/images948_png_jpg.rf.6de6e5b2ae57442fb8bc68eca1a744f4.jpg,164,286,46904,33538,13366
train/images948_png_jpg.rf.a8a6fa4c3d178f6fc2744c766e15c5ff.jpg,140,296,41440,27896,13544
train/images948_png_jpg.rf.c0a86820c7b44d6be546179564d57f51.jpg,178,333,59274,42986,16288
train/images939_png_jpg.rf.2073ec2b932dc8c5bf6fff35279d4a86.jpg,57,177,10089,8009,2080
train/images942_png_jpg.rf.bf611928bc34edfc1506d4ff4002611e.jpg,80,204,16320,13117,3203
train/images942_png_jpg.rf.bf611928bc34edfc1506d4ff4002611e.jpg,185,169,31265,24644,6621
train/images946_png_jpg.rf.ad2198ee71e2f9b877e050eaf25a22b9.jpg,150,259,38850,27676,11174
train/images987_png_jpg.rf.061c046166282d7986afbdf34c5172cd.jpg,27,84,2268,1396,872
train/images989_png_jpg.rf.18b33f2895514967d5821d603e03d4e3.jpg,69,171,11799,7834,3965
train/images989_png_jpg.rf.8be5fb995122f242e09b5637a60b018c.jpg,36,131,4716,2622,2094
train/images991_png_jpg.rf.33d89a8d8b1f8d9f7cadf07ded627dba.jpg,81,177,14337,9318,5019
train/images992_png_jpg.rf.23b82fc33de0e34a635a4e1da5d52b6c.jpg,54,206,11124,5405,5719
train/images992_png_jpg.rf.86ff56c10d5e32ae9826dbda2b1b9b6f.jpg,65,207,13455,7190,6265
train/images992_png_jpg.rf.981f212cd4b2f1bc4d0aca44f2c2c77b.jpg,80,201,16080,9942,6138
train/images993_png_jpg.rf.4d4f904bdc3bbd4d3d99f4b148633679.jpg,87,213,18531,12144,6387
train/images993_png_jpg.rf.6b217b271c1f31bd4ed5adac9b977270.jpg,106,189,20034,12241,7793
train/images993_png_jpg.rf.e5d2b92ada22ffac1178b4eb6a3eea36.jpg,129,205,26445,15481,10964
train/images994_png_jpg.rf.c3fc4b14c7ac52c8918c38479bf157f6.jpg,47,103,4841,3801,1040
train/images994_png_jpg.rf.ddf4d6486d8152606371031dca25485e.jpg,52,102,5304,4418,886
train/images995_png_jpg.rf.0c430794bcf1b1359ab4cd058012a58f.jpg,167,215,35905,20210,15695
train/images995_png_jpg.rf.1c171216ee4c76af8f891bc965e330bb.jpg,165,210,34650,18891,15759
train/images995_png_jpg.rf.79f658f5026ce517f17e99e05c4eba7b.jpg,157,218,34226,19333,14893
train/images996_png_jpg.rf.3ffc3cf2386b5bd6270821cc10758c3d.jpg,169,221,37349,21067,16282
train/images996_png_jpg.rf.7590b7a938c94eea36a0946c63c0d65f.jpg,180,222,39960,21521,18439
train/images996_png_jpg.rf.858e6e6da2eac8acd5f7d7a002d45ba1.jpg,186,223,41478,23517,17961
train/images997_png_jpg.rf.4226ceb38567e2f8a39c5bda65eae0ca.jpg,214,238,50932,29066,21866
train/images997_png_jpg.rf.927793bc04a57713b04ddf1885dffa9b.jpg,207,251,51957,30178,21779
train/images997_png_jpg.rf.fc69ca828b46ffc0e3c9c4d1a468db08.jpg,217,262,56854,32031,24823
train/images998_png_jpg.rf.1cefa0404c7cfca47fe8e7ddd57f2671.jpg,230,278,63940,37581,26359
train/images998_png_jpg.rf.48094ed01e0586d3afaf20eca8e4d94d.jpg,246,277,68142,37902,30240
train/images998_png_jpg.rf.f97b79653d2b096474f736a442026d28.jpg,233,271,63143,35011,28132
train/images999_png_jpg.rf.33f3fc0ec2563c7c6e4071025a460eb4.jpg,228,294,67032,41080,25952
train/images999_png_jpg.rf.35adc703af5cfde0fc0e8180a2d04833.jpg,250,275,68750,37288,31462
train/images999_png_jpg.rf.b4d3c901459c662b5446ea83912aaaac.jpg,238,271,64498,36710,27788
valid/images1002_png_jpg.rf.f41f0c8d6a662dbaebf3f801e7f5cf67.jpg,192,289,55488,32099,23389
valid/images1008_png_jpg.rf.9359b3e515f5825bdec9fa7d18f03fe8.jpg,58,71,4118,3123,995
valid/images1009_png_jpg.rf.f6c7a8a3e8d32fcc80c1fa8090086103.jpg,74,83,6142,4641,1501
valid/images102_png_jpg.rf.6d9caccaa5f1e8d08df7337a42c5756f.jpg,152,185,28120,19144,8976
valid/images1036_png_jpg.rf.224117105ae1f075ef0f4213eb6fc481.jpg,114,101,11514,8183,3331
valid/images1037_png_jpg.rf.480b2b0822005c82f87d9aad5e4ab6f8.jpg,140,111,15540,10776,4764
valid/images1062_png_jpg.rf.ad6ddbf65b093975f4a6350b99b4ee89.jpg,53,57,3021,2098,923
valid/images1064_png_jpg.rf.05685991038fe510f03424c2a6463559.jpg,96,73,7008,4485,2523
valid/images1090_png_jpg.rf.0c5ef9c131ccd3ef8eb04f0780f6eef5.jpg,196,226,44296,24307,19989
valid/images1091_png_jpg.rf.9a9c401813b6392dfee64aa61b4ceefa.jpg,208,233,48464,27126,21338
valid/images120_png_jpg.rf.33967745d12f0dfc15aec9adcf3a4997.jpg,47,165,7755,5002,2753
valid/images136_png_jpg.rf.a9ba34644e2969b94648c9f68a258c57.jpg,274,255,69870,54211,15659
valid/images147_png_jpg.rf.0da91e9f12319048653fa51f3a7e131f.jpg,106,233,24698,18386,6312
valid/images225_png_jpg.rf.2e8e4295d2752d25d37cb12932b820b4.jpg,126,188,23688,15183,8505
valid/images225_png_jpg.rf.2e8e4295d2752d25d37cb12932b820b4.jpg,114,155,17670,10968,6702
valid/images226_png_jpg.rf.3fdc57a4b92f6c6591cdb91e8cf885ba.jpg,150,184,27600,18030,9570
valid/images226_png_jpg.rf.3fdc57a4b92f6c6591cdb91e8cf885ba.jpg,147,152,22344,14067,8277
valid/images228_png_jpg.rf.8e75058f0be84dc850591a70b18d3fbd.jpg,184,167,30728,21631,9097
valid/images228_png_jpg.rf.8e75058f0be84dc850591a70b18d3fbd.jpg,224,140,31360,19263,12097
valid/images104_png_jpg.rf.0ce7dd6817fdcc5a113fd91fd80dae5d.jpg,218,180,39240,27823,11417
valid/images432_png_jpg.rf.cae7815c9636644e898fd77056c920cb.jpg,93,135,12555,10018,2537
valid/images432_png_jpg.rf.cae7815c9636644e898fd77056c920cb.jpg,159,102,16218,7376,8842
valid/images253_png_jpg.rf.0a551e26c336e80766eae778adb4d78c.jpg,55,133,7315,5618,1697
valid/images255_png_jpg.rf.1f80a6888ec248f7789db1e01c8fe2c2.jpg,119,131,15589,12069,3520
valid/images256_png_jpg.rf.f0576853908711a46565cf855580325f.jpg,310,183,56730,33843,22887
valid/images402_png_jpg.rf.1b9e2288d6eca88d3fa65ed4d9f9b938.jpg,34,183,6222,4851,1371
valid/images441_png_jpg.rf.739f6a2cad572b03f94b361fc0bde7f2.jpg,143,144,20592,15355,5237
valid/images441_png_jpg.rf.739f6a2cad572b03f94b361fc0bde7f2.jpg,185,148,27380,21245,6135
valid/images503_png_jpg.rf.3ac8712cf97a4e7c3af38d5f855b6b64.jpg,77,89,6853,4131,2722
valid/images504_png_jpg.rf.a8ace1188c7d27e69523f020b8239c0a.jpg,79,94,7426,4696,2730
valid/images509_png_jpg.rf.49a6789c7a77460499556648c8fd12fd.jpg,100,155,15500,9096,6404
valid/images518_png_jpg.rf.f1ef1bebf65e6203d6440f208fdf5b83.jpg,187,185,34595,28840,5755
valid/images518_png_jpg.rf.f1ef1bebf65e6203d6440f208fdf5b83.jpg,201,202,40602,27565,13037
valid/images520_png_jpg.rf.a15a455e845494246b6f3d7b0af920e1.jpg,150,198,29700,19382,10318
valid/images520_png_jpg.rf.a15a455e845494246b6f3d7b0af920e1.jpg,124,201,24924,20294,4630
valid/images536_png_jpg.rf.d9a1eb8c523c67c53173b03fc884f08b.jpg,165,125,20625,15650,4975
valid/images548_png_jpg.rf.9b4d3721d2669e91f1a9224db20bab4c.jpg,180,209,37620,20765,16855
valid/images551_png_jpg.rf.90e58b50a515d621970afd3571f8dffb.jpg,57,80,4560,3024,1536
valid/images600_png_jpg.rf.178599754622f37be192de0707c2b3a3.jpg,51,79,4029,3016,1013
valid/images681_png_jpg.rf.61e3b105c13ae2793d81b6280176c53b.jpg,68,159,10812,8398,2414
valid/images683_png_jpg.rf.a2e251d40cd36f6a34588b64c4ca3895.jpg,86,169,14534,11126,3408
valid/images689_png_jpg.rf.1adb10c7c36bf0e27132a243ec42fa04.jpg,114,187,21318,15625,5693
valid/images693_png_jpg.rf.3b688175305d0bb03480a1bbc9538cd1.jpg,133,205,27265,19668,7597
valid/images693_png_jpg.rf.3b688175305d0bb03480a1bbc9538cd1.jpg,69,194,13386,8436,4950
test/images1007_png_jpg.rf.08ddd4462a27f6b1fa637fb9d4211df4.jpg,48,64,3072,2309,763
test/images101_png_jpg.rf.9378fd09d66774f1ab9daa3894609a09.jpg,215,101,21715,15493,6222
test/images1063_png_jpg.rf.e13b1cb9814386de0a1c295af688f4db.jpg,81,66,5346,3447,1899
test/images1089_png_jpg.rf.122e62bfcf04c73211cc4d8b0952a0b7.jpg,64,89,5696,3947,1749
test/images128_png_jpg.rf.0f38a2338b8f0a52fef9bf89622fdf62.jpg,217,165,35805,15496,20309
test/images170_png_jpg.rf.f6dee61dcb80a3678dab1d65a4b02428.jpg,98,139,13622,10692,2930
test/images175_png_jpg.rf.b9e444d86d6892c8f5d856b1e8852105.jpg,141,208,29328,22379,6949
test/images196_png_jpg.rf.09d2b07cf31b4ae21e387399dc787d5f.jpg,96,55,5280,3758,1522
test/images310_png_jpg.rf.22ebb65f75e5ff331d88b9d249d251e2.jpg,75,179,13425,8666,4759
test/images38_png_jpg.rf.e7248358601b2286d73c584579f09d49.jpg,248,122,30256,17342,12914
test/images428_png_jpg.rf.fe6168dcf18cad81fef145a2b83d37ee.jpg,183,82,15006,9124,5882
test/images439_png_jpg.rf.7aaef783a603f28498487d5754907f5f.jpg,197,203,39991,32697,7294
test/images440_png_jpg.rf.1c8e413b36b6ac15c703d16b91df9bc2.jpg,176,152,26752,17040,9712
test/images45_png_jpg.rf.276f2990714d6c6be1c8873fdb5ab3eb.jpg,293,61,17873,13698,4175
test/images386_png_jpg.rf.2d0e5687c0ba39579b696e9f7d1c3dc2.jpg,128,230,29440,20025,9415
test/images611_png_jpg.rf.f7f65bc93f37fed432eb9455089ae645.jpg,59,82,4838,3783,1055
test/images643_png_jpg.rf.ecf48c67f94005082567765d295e8b51.jpg,87,87,7569,5033,2536
test/images643_png_jpg.rf.ecf48c67f94005082567765d295e8b51.jpg,88,76,6688,5476,1212
test/images643_png_jpg.rf.ecf48c67f94005082567765d295e8b51.jpg,88,70,6160,5242,918
test/images519_png_jpg.rf.0f79b9ef4727be8e3901a854b43ef582.jpg,177,185,32745,23537,9208
test/images519_png_jpg.rf.0f79b9ef4727be8e3901a854b43ef582.jpg,155,211,32705,25282,7423
test/images534_png_jpg.rf.befd9bdacfb46ed45f714cff7510a78a.jpg,236,193,45548,30978,14570
test/images534_png_jpg.rf.befd9bdacfb46ed45f714cff7510a78a.jpg,206,220,45320,30098,15222
test/images537_png_jpg.rf.265d962e619783a65dba5a2fe41f0d88.jpg,70,99,6930,5864,1066
test/images54_png_jpg.rf.7bbae43b9828bf9bfe891fd6a82b83b8.jpg,243,239,58077,30075,28002
test/images54_png_jpg.rf.7bbae43b9828bf9bfe891fd6a82b83b8.jpg,73,39,2847,1793,1054
test/images550_png_jpg.rf.0f6e63deff39d89afe46555068838ccc.jpg,159,123,19557,16371,3186
test/images56_png_jpg.rf.a49fda6e31d9ce1c1f1858d55456f10d.jpg,339,313,106107,55814,50293
test/images579_png_jpg.rf.f6dbd7251e5d1a9d0ee9f4347a3e06db.jpg,34,75,2550,1789,761
test/images57_png_jpg.rf.2f1b7a000e37544c491cd9c9871e0b78.jpg,288,368,105984,64762,41222
test/images590_png_jpg.rf.4ae7f65785bcd1fc12bc75d1dcc650d4.jpg,42,77,3234,2507,727
test/images622_png_jpg.rf.8e0b68ee37f6ab119590af89015f131f.jpg,66,82,5412,4268,1144
test/images622_png_jpg.rf.8e0b68ee37f6ab119590af89015f131f.jpg,71,76,5396,4197,1199
test/images633_png_jpg.rf.b3acaec9f1247035c615e85320e496c1.jpg,76,82,6232,4784,1448
test/images633_png_jpg.rf.b3acaec9f1247035c615e85320e496c1.jpg,79,80,6320,5042,1278
test/images674_png_jpg.rf.1350a201fc8df8f0673cb72f7ffef560.jpg,114,93,10602,6523,4079
test/images674_png_jpg.rf.1350a201fc8df8f0673cb72f7ffef560.jpg,104,89,9256,6898,2358
test/images675_png_jpg.rf.ec111645d3330346bce2aeda32a9e5d1.jpg,32,125,4000,2455,1545
test/images688_png_jpg.rf.9d92e0fafb2cd3d121d8b787dd02f65f.jpg,108,181,19548,14487,5061
test/images690_png_jpg.rf.473b49acfe23e43a730272e985e64fbd.jpg,118,190,22420,16349,6071
test/images690_png_jpg.rf.473b49acfe23e43a730272e985e64fbd.jpg,40,120,4800,2801,1999
test/images692_png_jpg.rf.b57febef802c43a527cb4e8c3924747e.jpg,131,197,25807,18700,7107
test/images692_png_jpg.rf.b57febef802c43a527cb4e8c3924747e.jpg,62,189,11718,7159,4559
test/images695_png_jpg.rf.c67139f37b09ea45327889352ff4e7a1.jpg,148,217,32116,22980,9136
test/images695_png_jpg.rf.c67139f37b09ea45327889352ff4e7a1.jpg,87,194,16878,11563,5315
test/images728_png_jpg.rf.7fe8647656ad9c99fe0a92225ee30b94.jpg,143,165,23595,15710,7885
test/images728_png_jpg.rf.7fe8647656ad9c99fe0a92225ee30b94.jpg,173,149,25777,16180,9597
test/images734_png_jpg.rf.69acecec7b05202805adc4998ddc005c.jpg,233,183,42639,25589,17050
test/images734_png_jpg.rf.69acecec7b05202805adc4998ddc005c.jpg,189,178,33642,23152,10490
