imgpath,height,width,area,pothole_area,nonpothole_area
train/images1004_png_jpg.rf.1e247476232754c14cce2a445aa0b28e.jpg,64,76,4864,3197,1667
train/images1004_png_jpg.rf.1e247476232754c14cce2a445aa0b28e.jpg,60,51,3060,2595,465
train/images1004_png_jpg.rf.7f3d9c2cb9a3af7e8d11c88f463a330a.jpg,65,74,4810,2833,1977
train/images1004_png_jpg.rf.7f3d9c2cb9a3af7e8d11c88f463a330a.jpg,60,71,4260,3118,1142
train/images1005_png_jpg.rf.21b7d2f2dc1a235b6b71a38119beaa82.jpg,160,116,18560,15633,2927
train/images1005_png_jpg.rf.86c56d193a5dfa4dae23d37ddb492ba1.jpg,152,104,15808,12869,2939
train/images1005_png_jpg.rf.8817322ef32a7951d4545907bb7190d7.jpg,163,107,17441,15029,2412
train/images1006_png_jpg.rf.74c5bbcd80df2626fa58d7c77e160ef5.jpg,21,55,1155,959,196
train/images1006_png_jpg.rf.a16ed0fb0972849026c884b464473c44.jpg,44,60,2640,2119,521
train/images1006_png_jpg.rf.aa2273409e2835321d34c832cb242c74.jpg,47,60,2820,2219,601
train/images100_png_jpg.rf.31613beeb9d0ca1787b171cf869fad32.jpg,46,107,4922,3251,1671
train/images100_png_jpg.rf.34e5d110b4b7f8ab6693f9ed23f14e07.jpg,55,132,7260,4770,2490
train/images100_png_jpg.rf.a9d7ede906f2a17578c0bd8b4cfaef8d.jpg,75,147,11025,8007,3018
train/images1016_png_jpg.rf.16e8a45883915f3d6bae0715a96566a9.jpg,150,109,16350,13049,3301
train/images1016_png_jpg.rf.47a62f7fbded40a3bc97238477798ada.jpg,149,106,15794,12661,3133
train/images1004_png_jpg.rf.6281d3d37e9886a4167ab32317c2c861.jpg,62,70,4340,2883,1457
train/images1004_png_jpg.rf.6281d3d37e9886a4167ab32317c2c861.jpg,57,70,3990,1556,2434
train/images1016_png_jpg.rf.71281378c286e3fc8afbfc720ebe02ee.jpg,119,101,12019,9584,2435
train/images1022_png_jpg.rf.15095d3c94bbdfe51bb8071cbd293f7c.jpg,39,54,2106,1446,660
train/images1026_png_jpg.rf.043039548d7702026011be310c441db0.jpg,146,110,16060,12692,3368
train/images1030_png_jpg.rf.cf45f3f1169dc4884c4232678b48fa17.jpg,65,73,4745,3244,1501
train/images1019_png_jpg.rf.43e811d867768490f5b9b01bda7b41f0.jpg,31,47,1457,1006,451
train/images1019_png_jpg.rf.57203fdb8224d65396da05332f2d9392.jpg,30,49,1470,1038,432
train/images1020_png_jpg.rf.0b7d05d178fcb3dc0531c47b3938fa6e.jpg,29,49,1421,1024,397
train/images1022_png_jpg.rf.085c9cec9809facdf828f99032c11e5b.jpg,38,54,2052,1419,633
train/images1022_png_jpg.rf.293db7cdc045ce3169f6a181174f0832.jpg,37,53,1961,1390,571
train/images1023_png_jpg.rf.0a1974ef2f6eed142105d8690f3debe2.jpg,42,58,2436,1735,701
train/images1023_png_jpg.rf.6753d2563e34fee9bcb7613116d11e89.jpg,42,58,2436,1725,711
train/images1023_png_jpg.rf.f19e4704a323be28b2655b90f5c70e20.jpg,41,56,2296,1600,696
train/images1024_png_jpg.rf.2daf657f0fb44379dc6277f1306adae4.jpg,44,58,2552,1777,775
train/images1024_png_jpg.rf.93f1544a6dffc6e96aceab334e8e56a9.jpg,49,60,2940,1993,947
train/images1024_png_jpg.rf.df5a36412923e565982d34912e06bb91.jpg,44,58,2552,1773,779
train/images1025_png_jpg.rf.06c45563567193ab4bb96916e5634a3a.jpg,48,60,2880,1944,936
train/images1025_png_jpg.rf.383d1be2e0f04d3e05e1d69c451b16b3.jpg,50,62,3100,2132,968
train/images1025_png_jpg.rf.dc58b29b03f5d1ca3b4cbc17f66a0f8c.jpg,48,62,2976,2045,931
train/images1026_png_jpg.rf.7f43c1d03b69ca0d250b1453f24a60d7.jpg,162,116,18792,15621,3171
train/images1026_png_jpg.rf.f14ca34f95869ce2804c1627ca8bc6d9.jpg,150,116,17400,13616,3784
train/images1028_png_jpg.rf.a275df74b23e38c7c1c32f16c19784b7.jpg,58,68,3944,2712,1232
train/images1028_png_jpg.rf.e57276f5202dbdc493b8edc16dad3da1.jpg,54,63,3402,2362,1040
train/images1028_png_jpg.rf.e8b6244bf692ca6b27a075dab37f4308.jpg,54,63,3402,2386,1016
train/images1029_png_jpg.rf.297df2d9e07193c95073bad93ec35e84.jpg,60,69,4140,2858,1282
train/images1029_png_jpg.rf.a2a1da53ab168c04c78fbb01ef4bcef8.jpg,62,70,4340,3039,1301
train/images1029_png_jpg.rf.e50315cd9446289ac093fab5c7651738.jpg,60,71,4260,2944,1316
train/images1030_png_jpg.rf.432f37baa0b0bf9f5d5d4cfc3cd7225d.jpg,64,72,4608,3158,1450
train/images1030_png_jpg.rf.c88acbe3a153332bde7c6ee31a73d87c.jpg,64,74,4736,3459,1277
train/images1031_png_jpg.rf.1df391e7d1359dae1c7ca86f9b08eb7d.jpg,49,83,4067,3199,868
train/images1031_png_jpg.rf.b0cd4e7c63c99ae74ca6c7fa0d60dd09.jpg,59,82,4838,3888,950
train/images1031_png_jpg.rf.cf3357f5719b7e722fa406e4d996d6fe.jpg,71,80,5680,4053,1627
train/images1032_png_jpg.rf.8a96842d02b039ced2d38e883bd8ebe8.jpg,29,79,2291,1550,741
train/images1032_png_jpg.rf.a1feb3358dbbeedce1758a541692d13e.jpg,22,74,1628,1010,618
train/images1033_png_jpg.rf.34dd0e5a24dc5621ed383c95fb096b38.jpg,37,89,3293,2311,982
train/images1033_png_jpg.rf.f2baf5d85ab227c251af7b74ef1209de.jpg,26,76,1976,1163,813
train/images1047_png_jpg.rf.14ede0293315bd5629b0b35564482b6b.jpg,121,114,13794,10621,3173
train/images1047_png_jpg.rf.14ede0293315bd5629b0b35564482b6b.jpg,16,36,576,450,126
train/images1047_png_jpg.rf.d875e497795159d191d87e7979b1cf0b.jpg,104,108,11232,8494,2738
train/images1047_png_jpg.rf.dc5073439b671c4dfa38b3b3c9cae99f.jpg,106,109,11554,8913,2641
train/images1047_png_jpg.rf.dc5073439b671c4dfa38b3b3c9cae99f.jpg,16,35,560,450,110
train/images1079_png_jpg.rf.150b02beaf23b9768169ca10958cbdb0.jpg,104,176,18304,10689,7615
train/images1079_png_jpg.rf.6938a2121cc49c68fd6036fb1a4f48b2.jpg,98,164,16072,9468,6604
train/images1079_png_jpg.rf.d0d826c435a702caf5bd30c8f8700982.jpg,89,164,14596,8891,5705
train/images1080_png_jpg.rf.044c8bcefc41c25e6d02b56c39a19b3d.jpg,69,152,10488,6144,4344
train/images1080_png_jpg.rf.8c0052ffb1fbe34d45e4798f912352cb.jpg,71,155,11005,6658,4347
train/images1080_png_jpg.rf.c22833fd96f46823619fcb8179398fb8.jpg,73,157,11461,6943,4518
train/images1081_png_jpg.rf.4eac0a461379e2b202e440cb377f38b6.jpg,29,74,2146,1331,815
train/images1081_png_jpg.rf.85e89398c8bedd72405e97ef3d53992f.jpg,74,157,11618,6930,4688
train/images1081_png_jpg.rf.d85ba155adafc49cb0e08279c4f4c377.jpg,87,179,15573,9537,6036
train/images1082_png_jpg.rf.07da7a22e990801653d17de98a05f0c3.jpg,59,133,7847,4457,3390
train/images1082_png_jpg.rf.b2db4d622da664e7bfd6f3f82c519740.jpg,45,106,4770,2824,1946
train/images1083_png_jpg.rf.133c4571a70483671fcf8c2ee126d64f.jpg,52,124,6448,3688,2760
train/images1083_png_jpg.rf.6ecbe90047468a7bb22d20cf7fb236c8.jpg,53,121,6413,3736,2677
train/images1083_png_jpg.rf.e512a9e7876cff590e03317519ba13c5.jpg,60,138,8280,4646,3634
train/images1084_png_jpg.rf.19ab3f25ee1b1bbcb470f4fce510c16c.jpg,24,60,1440,1020,420
train/images1084_png_jpg.rf.7236ff6a46df506c83215a4cf8fa7fe0.jpg,32,72,2304,1602,702
train/images1085_png_jpg.rf.05ced665f5a4d5eaaa1e8290b32c7c90.jpg,56,122,6832,4191,2641
train/images1086_png_jpg.rf.7a66ef397f8a40b28cc36841179e29f9.jpg,34,79,2686,1826,860
train/images10_png_jpg.rf.6a20b0141debf9d1956039c2f7757d23.jpg,66,99,6534,4547,1987
train/images10_png_jpg.rf.ba54c6d347a6328c3b377e234def00e7.jpg,66,97,6402,4489,1913
train/images1106_png_jpg.rf.3beaa96ce33db5e0ef04280858021a8e.jpg,39,45,1755,1180,575
train/images1106_png_jpg.rf.768a9db62d3bed0aa708b56e22beb5e6.jpg,35,45,1575,1102,473
train/images1106_png_jpg.rf.9a0d5e26e468f2d05b87ae4df36573d4.jpg,36,43,1548,1113,435
train/images1160_png_jpg.rf.35ac840bb22efd4bbff8f2bc736646c4.jpg,33,54,1782,1247,535
train/images1160_png_jpg.rf.d95d1b30894912b6bea7a95dd4a2e9e3.jpg,33,53,1749,1229,520
train/images1160_png_jpg.rf.dde1cb2bc08af0ff541465f4a14b8ce5.jpg,32,54,1728,1251,477
train/images1161_png_jpg.rf.68b980c5c8b3c6f107341e2305080182.jpg,43,65,2795,2041,754
train/images1161_png_jpg.rf.836231794b8cafbcdf49985b01053e5e.jpg,41,62,2542,1810,732
train/images1161_png_jpg.rf.dc1b885082cd4b6908f6dce4c2693a92.jpg,42,65,2730,2030,700
train/images1174_png_jpg.rf.2e43c167b65003cb797fc2cdb4b69985.jpg,50,117,5850,4871,979
train/images1174_png_jpg.rf.64f956836e6c6f4c9f885d903fe4ba10.jpg,49,119,5831,4677,1154
train/images1174_png_jpg.rf.9bc4cca51aa5510665fb5533697ec4fe.jpg,49,118,5782,4679,1103
train/images117_png_jpg.rf.79ec0ab0857de85b52b7e753ebb4c2f1.jpg,90,159,14310,10572,3738
train/images117_png_jpg.rf.b58da63ec7eb6009da401cb0ffdb0d0a.jpg,96,156,14976,11334,3642
train/images117_png_jpg.rf.cab6261e0c59c30cbeb909e2ee082557.jpg,102,159,16218,12265,3953
train/images1185_png_jpg.rf.6c6d9b067a5e62accd7c20bb3847cdcd.jpg,59,133,7847,5759,2088
train/images1185_png_jpg.rf.6edde80cfaee04531173874ae7bc1097.jpg,56,131,7336,5794,1542
train/images121_png_jpg.rf.95584d55c38af5641449ab14502b9ffa.jpg,52,128,6656,5347,1309
train/images124_png_jpg.rf.33246038b122b7e8168c45335b194e03.jpg,105,138,14490,9315,5175
train/images124_png_jpg.rf.60ce846673ec7f883a7f85bceb023f41.jpg,94,139,13066,8422,4644
train/images124_png_jpg.rf.752ce4b7e8d1aacd7917fdb2601b47b1.jpg,93,142,13206,8680,4526
train/images1261_png_jpg.rf.0e3e1163ead6f161ce550fa10fa4340e.jpg,38,102,3876,2718,1158
train/images126_png_jpg.rf.154c7db2506619181fdebb5cf66c8e8b.jpg,48,60,2880,2228,652
train/images126_png_jpg.rf.154c7db2506619181fdebb5cf66c8e8b.jpg,108,43,4644,3532,1112
train/images126_png_jpg.rf.154c7db2506619181fdebb5cf66c8e8b.jpg,63,95,5985,4554,1431
train/images126_png_jpg.rf.4d89dd514675d6b333da7f41b74ce006.jpg,117,41,4797,3605,1192
train/images126_png_jpg.rf.4d89dd514675d6b333da7f41b74ce006.jpg,35,57,1995,1656,339
train/images126_png_jpg.rf.4d89dd514675d6b333da7f41b74ce006.jpg,54,84,4536,3313,1223
train/images126_png_jpg.rf.53d8b26c40271c3893dffc1a49d87235.jpg,126,43,5418,3775,1643
train/images1333_png_jpg.rf.4c13eba7cf47ead32597de33e1ed9cf8.jpg,24,97,2328,1693,635
train/images1333_png_jpg.rf.4c13eba7cf47ead32597de33e1ed9cf8.jpg,60,165,9900,5672,4228
train/images1333_png_jpg.rf.4c13eba7cf47ead32597de33e1ed9cf8.jpg,47,193,9071,6084,2987
train/images1333_png_jpg.rf.59b13333ab7e57bd7c80e9393a1fc7af.jpg,56,174,9744,6007,3737
train/images1333_png_jpg.rf.59b13333ab7e57bd7c80e9393a1fc7af.jpg,25,101,2525,1830,695
train/images1333_png_jpg.rf.8a1536d6dbf15ea8159e9ce2d4d39cce.jpg,64,168,10752,6469,4283
train/images1333_png_jpg.rf.8a1536d6dbf15ea8159e9ce2d4d39cce.jpg,24,101,2424,1823,601
train/images1375_png_jpg.rf.1e00d99daf7aa492688a9c4fa9df5f5c.jpg,76,191,14516,9153,5363
train/images1375_png_jpg.rf.1e00d99daf7aa492688a9c4fa9df5f5c.jpg,46,135,6210,4111,2099
train/images1375_png_jpg.rf.66fb4365bd330a4f88040fb7663a943d.jpg,74,202,14948,9384,5564
train/images1375_png_jpg.rf.66fb4365bd330a4f88040fb7663a943d.jpg,43,69,2967,1875,1092
train/images137_png_jpg.rf.7394560a64789b0fa7e9f8f7fb2b1c8f.jpg,47,95,4465,3314,1151
train/images137_png_jpg.rf.7394560a64789b0fa7e9f8f7fb2b1c8f.jpg,28,53,1484,1156,328
train/images137_png_jpg.rf.a422f7401fbe90b4bebc8eedd0e3e234.jpg,52,142,7384,6043,1341
train/images137_png_jpg.rf.a422f7401fbe90b4bebc8eedd0e3e234.jpg,43,87,3741,2824,917
train/images137_png_jpg.rf.a422f7401fbe90b4bebc8eedd0e3e234.jpg,28,46,1288,971,317
train/images137_png_jpg.rf.d7b0fe630bd3ce438b026c215226c4f6.jpg,59,164,9676,7581,2095
train/images137_png_jpg.rf.d7b0fe630bd3ce438b026c215226c4f6.jpg,32,101,3232,2365,867
train/images140_png_jpg.rf.943d68e48b5b53a2c8e04b75ad9a32e6.jpg,52,100,5200,3734,1466
train/images140_png_jpg.rf.b79bc71eec6a60094472623fae573689.jpg,53,95,5035,3565,1470
train/images159_png_jpg.rf.53d3b416c5ff812f8f3ec1aaa3cac6fb.jpg,34,84,2856,2180,676
train/images159_png_jpg.rf.5533592c80bdd356f868d38994d5febb.jpg,32,84,2688,2110,578
train/images159_png_jpg.rf.c65819319398141a92c89c77e74ffcda.jpg,34,81,2754,2163,591
train/images160_png_jpg.rf.bc06120406ed447554b20c9013b08e73.jpg,33,85,2805,2314,491
train/images160_png_jpg.rf.df6ef3504577b23a6c2e419602464e6c.jpg,32,87,2784,2210,574
train/images160_png_jpg.rf.e6c053a2fa3178880816960a43b3d09b.jpg,32,84,2688,2169,519
train/images163_png_jpg.rf.1b53de9a9d31d1e8ae11e9b2af86ad00.jpg,50,107,5350,4009,1341
train/images163_png_jpg.rf.a0926588b73aa8dd7a539555e7a58561.jpg,45,101,4545,3458,1087
train/images164_png_jpg.rf.908291f5235e251452bd3c62e123efed.jpg,58,44,2552,1870,682
train/images164_png_jpg.rf.908291f5235e251452bd3c62e123efed.jpg,19,39,741,550,191
train/images164_png_jpg.rf.c962a804242656525f1079b3736c5847.jpg,37,48,1776,1370,406
train/images164_png_jpg.rf.c962a804242656525f1079b3736c5847.jpg,55,43,2365,1777,588
train/images164_png_jpg.rf.f217ed9a0563e9bb72f336213bdeecc9.jpg,40,57,2280,1643,637
train/images164_png_jpg.rf.f217ed9a0563e9bb72f336213bdeecc9.jpg,65,46,2990,1992,998
train/images166_png_jpg.rf.1bde0787e69e5106e3a0f1717ef219b9.jpg,57,112,6384,4686,1698
train/images166_png_jpg.rf.d5e84dd50d88e7e817f0abdea50f95d1.jpg,58,115,6670,5086,1584
train/images166_png_jpg.rf.de40c797a785aa2b8935bba91fcca54a.jpg,52,108,5616,4416,1200
train/images1085_png_jpg.rf.c57107ea58bd9c3f05fe8eb9062cf658.jpg,48,106,5088,3121,1967
train/images10_png_jpg.rf.cb382006cd28e7937a391fd1397d482c.jpg,66,95,6270,4302,1968
train/images1185_png_jpg.rf.29c26d26e539a21580408bfaf7b5e885.jpg,51,122,6222,4800,1422
train/images1375_png_jpg.rf.21dd85b5b01bc3da5b2ba711633741b1.jpg,77,180,13860,8487,5373
train/images1375_png_jpg.rf.21dd85b5b01bc3da5b2ba711633741b1.jpg,39,108,4212,3123,1089
train/images163_png_jpg.rf.eb5e307b90ec700db7286aae9e321a76.jpg,46,102,4692,3581,1111
train/images16_png_jpg.rf.490a1802f8b1a9f6370dd25552a491cd.jpg,93,122,11346,7882,3464
train/images16_png_jpg.rf.c77d88593304f267e5f8199f154a3be6.jpg,88,120,10560,7714,2846
train/images16_png_jpg.rf.f0df86891eb02ac0956f8361a04931d0.jpg,87,115,10005,6963,3042
train/images174_png_jpg.rf.138dd0bdb1c1fca9310944aece135184.jpg,57,44,2508,1943,565
train/images174_png_jpg.rf.138dd0bdb1c1fca9310944aece135184.jpg,62,98,6076,3815,2261
train/images174_png_jpg.rf.54a19f8f67a2f768286c2fc39fa14070.jpg,48,66,3168,2169,999
train/images174_png_jpg.rf.fa978214a0e311ffe2ec75fd3e96f3bf.jpg,56,91,5096,2901,2195
train/images17_png_jpg.rf.6f7f93f1ffa35516b8bb263d2d268bfc.jpg,102,136,13872,9351,4521
train/images17_png_jpg.rf.f5d6fa2768f4d83c5a5dd2c4ad452375.jpg,98,128,12544,8610,3934
train/images17_png_jpg.rf.fc151b4e7b118980aa1069563eabe87f.jpg,90,118,10620,7728,2892
train/images197_png_jpg.rf.5099f078fdcdd609a787ca285556e76f.jpg,53,155,8215,5092,3123
train/images197_png_jpg.rf.8a7dfdf08465aa80b3825ed5fa533fe7.jpg,76,163,12388,7456,4932
train/images198_png_jpg.rf.453239aa12b891b235cc02c9e2c94099.jpg,61,143,8723,5827,2896
train/images198_png_jpg.rf.74673f8cedf2c449106f0a06d6452f90.jpg,62,139,8618,6058,2560
train/images198_png_jpg.rf.e28eac2e53ea07d8e255b366d1b65533.jpg,70,167,11690,7182,4508
train/images199_png_jpg.rf.0c74098685f548b7eb14a554755da1bd.jpg,83,164,13612,8113,5499
train/images199_png_jpg.rf.77bb81fc1168820166c2736415141982.jpg,75,186,13950,8801,5149
train/images207_png_jpg.rf.73364a6fa5d2123c605dbae784f44808.jpg,118,118,13924,8120,5804
train/images207_png_jpg.rf.c3f35f4e48833596d29ead392236f0f2.jpg,125,119,14875,8264,6611
train/images20_png_jpg.rf.1c6fb8e38ef0ba9f310cd4c25b3a564b.jpg,97,140,13580,10550,3030
train/images20_png_jpg.rf.522e815f84ff0651411d4bb90408ec53.jpg,86,154,13244,10081,3163
train/images20_png_jpg.rf.c9fd1e5f462808848b02d933882ece60.jpg,127,158,20066,13090,6976
train/images217_png_jpg.rf.8f3968baf81f1dcbe0499d48d9cd7542.jpg,148,137,20276,12077,8199
train/images217_png_jpg.rf.96264036fe7a427b730cf5e4fa7b0367.jpg,112,132,14784,9588,5196
train/images217_png_jpg.rf.d70e057e2223566b8def9a178a3c1eba.jpg,156,136,21216,11739,9477
train/images220_png_jpg.rf.3e7f5a869e445e8eeaaf5e7f408c17c2.jpg,87,160,13920,8080,5840
train/images220_png_jpg.rf.3e7f5a869e445e8eeaaf5e7f408c17c2.jpg,31,64,1984,1421,563
train/images220_png_jpg.rf.3e7f5a869e445e8eeaaf5e7f408c17c2.jpg,99,145,14355,8182,6173
train/images220_png_jpg.rf.a1eadc1a8c8bdfe5f4d9eb6d7757eb09.jpg,86,175,15050,8472,6578
train/images220_png_jpg.rf.a1eadc1a8c8bdfe5f4d9eb6d7757eb09.jpg,87,141,12267,7480,4787
train/images220_png_jpg.rf.a1eadc1a8c8bdfe5f4d9eb6d7757eb09.jpg,35,59,2065,1279,786
train/images223_png_jpg.rf.788ff33eadfd310b12a3106e217028a9.jpg,54,168,9072,5886,3186
train/images223_png_jpg.rf.788ff33eadfd310b12a3106e217028a9.jpg,39,57,2223,1518,705
train/images223_png_jpg.rf.e83ee4a4e259fea7471a77750a1f86f6.jpg,38,60,2280,1486,794
train/images223_png_jpg.rf.e83ee4a4e259fea7471a77750a1f86f6.jpg,48,166,7968,4875,3093
train/images223_png_jpg.rf.ed39c22c379545ce9e9a1e8acfb3d67e.jpg,37,67,2479,1559,920
train/images224_png_jpg.rf.445fd5de3e2c02a2d2c9666bb419e7c5.jpg,41,63,2583,1736,847
train/images224_png_jpg.rf.4cf5556fdb8dadfa108045ffc9b30dd0.jpg,41,65,2665,1767,898
train/images224_png_jpg.rf.dd5eeba2db144910d9be06b67b230151.jpg,41,61,2501,1637,864
train/images227_png_jpg.rf.15d15a2cffc9eb45851f7f92e75d401f.jpg,54,74,3996,2701,1295
train/images227_png_jpg.rf.c6b1757152032c6794334a2b7dc61334.jpg,56,81,4536,2954,1582
train/images229_png_jpg.rf.a623c31e8efa6c2a9a125d9fbfc2f18a.jpg,56,91,5096,3365,1731
train/images229_png_jpg.rf.b857847cdfcd10db8e0018dad9885aad.jpg,43,89,3827,2383,1444
train/images238_png_jpg.rf.35bd9cc87d169c609683aa54f719f857.jpg,95,154,14630,9508,5122
train/images238_png_jpg.rf.fbedf9f2d1d3258c2f512ce3b4c8d6de.jpg,99,156,15444,9451,5993
train/images23_png_jpg.rf.9854a4456d47da834bd36ea71d6d8e01.jpg,22,46,1012,807,205
train/images245_png_jpg.rf.2f699025fecc99be514b909201da3713.jpg,22,93,2046,1488,558
train/images245_png_jpg.rf.dbfb8a3347a18f377059b6a625ec8b6d.jpg,32,84,2688,2086,602
train/images246_png_jpg.rf.b5db552ee905cf8bf017ba578b72d3b9.jpg,41,94,3854,2841,1013
train/images246_png_jpg.rf.f9965a9296c2983947bb83aafb00384e.jpg,39,90,3510,2581,929
train/images247_png_jpg.rf.21c83f3486042711508a69a7c1391127.jpg,41,99,4059,2901,1158
train/images247_png_jpg.rf.d5ed5c2d6841200fcb2a82c36ac8c078.jpg,44,100,4400,3153,1247
train/images247_png_jpg.rf.fc23b0abb9b39ff680517463efb4fa7f.jpg,44,101,4444,3181,1263
train/images249_png_jpg.rf.2cb624135184ea87d2218f9acecd4cc5.jpg,60,81,4860,3157,1703
train/images249_png_jpg.rf.f1a6e7100f656d71f86a2ec35dc2b3e1.jpg,73,79,5767,3911,1856
train/images250_png_jpg.rf.81380bb11f5a33a9dac816b558483c52.jpg,54,111,5994,4459,1535
train/images250_png_jpg.rf.d9c9f789f0c863196d53886c5704334c.jpg,54,111,5994,4420,1574
train/images250_png_jpg.rf.dcc8bb76218ac273f9decac58244c8ae.jpg,55,111,6105,4511,1594
train/images281_png_jpg.rf.1ab6e31ce40599f7ec2f422f6dc044ba.jpg,52,112,5824,4515,1309
train/images281_png_jpg.rf.5b8f8cb349e04ddbd71df308383f1a25.jpg,54,111,5994,4571,1423
train/images281_png_jpg.rf.d5583635ae0b2494eea6690343bb97d6.jpg,55,116,6380,5012,1368
train/images286_png_jpg.rf.1245b45e703abcce37cb68058cac72c4.jpg,155,158,24490,16916,7574
train/images286_png_jpg.rf.1245b45e703abcce37cb68058cac72c4.jpg,60,61,3660,1531,2129
train/images286_png_jpg.rf.1245b45e703abcce37cb68058cac72c4.jpg,107,45,4815,3950,865
train/images286_png_jpg.rf.3148c97f0e28b8053c45b62ffe5b4f8b.jpg,147,168,24696,15390,9306
train/images286_png_jpg.rf.3148c97f0e28b8053c45b62ffe5b4f8b.jpg,59,61,3599,1526,2073
train/images286_png_jpg.rf.3148c97f0e28b8053c45b62ffe5b4f8b.jpg,34,55,1870,1473,397
train/images286_png_jpg.rf.ef6e693404d5530a84a71ea04e994655.jpg,138,158,21804,14264,7540
train/images286_png_jpg.rf.ef6e693404d5530a84a71ea04e994655.jpg,55,56,3080,1303,1777
train/images286_png_jpg.rf.ef6e693404d5530a84a71ea04e994655.jpg,105,28,2940,2183,757
train/images287_png_jpg.rf.6475bafdfacf807d73b21500423660dc.jpg,138,178,24564,15163,9401
train/images287_png_jpg.rf.6475bafdfacf807d73b21500423660dc.jpg,73,65,4745,2139,2606
train/images287_png_jpg.rf.64e8290876f58faa7c557f1a2bd317fd.jpg,73,64,4672,1996,2676
train/images287_png_jpg.rf.64e8290876f58faa7c557f1a2bd317fd.jpg,115,144,16560,10009,6551
train/images207_png_jpg.rf.8b66bb6dc50deac80e1f17fd6295c04a.jpg,90,114,10260,6176,4084
train/images220_png_jpg.rf.2dda2e1f55765315890e75c87f74eba9.jpg,79,157,12403,8132,4271
train/images220_png_jpg.rf.2dda2e1f55765315890e75c87f74eba9.jpg,36,62,2232,1438,794
train/images220_png_jpg.rf.2dda2e1f55765315890e75c87f74eba9.jpg,84,139,11676,7134,4542
train/images227_png_jpg.rf.cd71f666a365d5d63294d6f5dc668984.jpg,53,75,3975,2646,1329
train/images23_png_jpg.rf.9f842ef2fa31ec6c6a70e01dc28cb544.jpg,26,43,1118,859,259
train/images249_png_jpg.rf.72f757707c2d377354fb4e4ad0996847.jpg,92,83,7636,5490,2146
train/images1082_png_jpg.rf.0027d255e51683fdb0c4362592ee9e33.jpg,47,106,4982,2810,2172
train/images287_png_jpg.rf.f714afc3b2e5873421c2f2031dac72ac.jpg,101,170,17170,10853,6317
train/images287_png_jpg.rf.f714afc3b2e5873421c2f2031dac72ac.jpg,64,64,4096,2001,2095
train/images555_png_jpg.rf.d9966f25396dc7c9ee62c101a49a2cb4.jpg,37,84,3108,2482,626
train/images670_png_jpg.rf.169e66d139bf1672b61aae90e750265c.jpg,73,160,11680,8639,3041
train/images670_png_jpg.rf.169e66d139bf1672b61aae90e750265c.jpg,53,143,7579,5343,2236
train/images288_png_jpg.rf.02750d10ec553a79295ed9e830a20a5d.jpg,83,162,13446,7586,5860
train/images288_png_jpg.rf.126f475057844e3eba22eb589a765ce4.jpg,65,148,9620,5828,3792
train/images288_png_jpg.rf.288d3f215e3afa6df3101b48b8625bdd.jpg,98,73,7154,3308,3846
train/images2_png_jpg.rf.e9845addcd42afe819d69ec0cdc7fcf8.jpg,29,36,1044,865,179
train/images305_png_jpg.rf.3392ac944ea589ca94fe4dd22856cbe2.jpg,23,81,1863,1013,850
train/images306_png_jpg.rf.7bd00c806c5536bb3b588b8b60142879.jpg,31,103,3193,1713,1480
train/images306_png_jpg.rf.a30a0548f3f3988fb2425d0feccaacd7.jpg,34,102,3468,1955,1513
train/images306_png_jpg.rf.d494fdc533ca5265ff4fea6d210a1033.jpg,32,114,3648,1954,1694
train/images307_png_jpg.rf.b5d18184d7eb53e6ff83e266e4a9c385.jpg,37,123,4551,2218,2333
train/images307_png_jpg.rf.eb97e850bd1259a4e0033f9f2a0da107.jpg,33,116,3828,2004,1824
train/images308_png_jpg.rf.b7ce014fa99d80ee24fca1bd54e7f59a.jpg,46,140,6440,3304,3136
train/images308_png_jpg.rf.da4172d2f1e93b9d132748bc8a1b9859.jpg,44,129,5676,3002,2674
train/images308_png_jpg.rf.e95736354e415326fbddaadc0f5a2665.jpg,44,133,5852,3042,2810
train/images309_png_jpg.rf.5f6ab3952bbe8aa7939b9459ce8468d5.jpg,61,167,10187,5330,4857
train/images309_png_jpg.rf.eefeafed00f637959367b96615a4ee31.jpg,40,157,6280,3861,2419
train/images31_png_jpg.rf.59082db5683f712d9b832d5f691ca916.jpg,60,59,3540,2504,1036
train/images31_png_jpg.rf.c56f771bc4eee40a0cdb88b4898fb10a.jpg,48,60,2880,2036,844
train/images31_png_jpg.rf.ef4a4d441392576134a58a3badc10b38.jpg,66,60,3960,2768,1192
train/images32_png_jpg.rf.278bbab992bf5f215ee3bd7b5c0f5833.jpg,88,67,5896,3621,2275
train/images32_png_jpg.rf.8291d87e96dc8cbbbc66314433f36ae9.jpg,55,60,3300,2393,907
train/images32_png_jpg.rf.d8bd792d2d857cff768a65f0d097744c.jpg,81,64,5184,3332,1852
train/images33_png_jpg.rf.1f328f6aefb23b53c5e8aeb68d521c1f.jpg,102,72,7344,4679,2665
train/images33_png_jpg.rf.81f3a14eb2ec3cbb9aed9969a9f60420.jpg,102,75,7650,5085,2565
train/images36_png_jpg.rf.342d1d53e8a819d4b99e224e68382ef2.jpg,89,89,7921,5699,2222
train/images36_png_jpg.rf.69b9b099fec5a226b56fdbb3ccebc2ae.jpg,92,85,7820,5793,2027
train/images36_png_jpg.rf.bed011f768e017f40a757f1e33d6f39e.jpg,117,88,10296,7506,2790
train/images379_png_jpg.rf.58dfea96fe6bafa13430dfaa0c09002a.jpg,72,173,12456,9086,3370
train/images379_png_jpg.rf.819f2c99ff17d51e5af7d63f5271ed92.jpg,70,177,12390,9135,3255
train/images379_png_jpg.rf.eb5fc30b69becb57fffa308a62c6e373.jpg,75,184,13800,9692,4108
train/images37_png_jpg.rf.4cb7bd0a908898058c747cbe9df1cbd8.jpg,35,32,1120,823,297
train/images37_png_jpg.rf.4cb7bd0a908898058c747cbe9df1cbd8.jpg,40,59,2360,1876,484
train/images37_png_jpg.rf.9374a5e0409eee3fefb7b1a33ce627c9.jpg,96,110,10560,7264,3296
train/images37_png_jpg.rf.f7aa855673a7c7ddb0b481af73f1ec3c.jpg,54,87,4698,2815,1883
train/images380_png_jpg.rf.32859dda00db815c613706559e3d498b.jpg,71,176,12496,9309,3187
train/images380_png_jpg.rf.806b8758cf2b01ce57241ed5cc6a5aff.jpg,74,176,13024,9381,3643
train/images381_png_jpg.rf.0e159faa65cb86e8062580c1f45e202f.jpg,76,187,14212,10576,3636
train/images381_png_jpg.rf.2ad2a7891920877791c002d7e453ba29.jpg,83,185,15355,11254,4101
train/images381_png_jpg.rf.f595b64b70813527c424936efbc4377a.jpg,87,200,17400,12367,5033
train/images382_png_jpg.rf.8d5b465f0253c5389b47b5fb6f34c412.jpg,86,196,16856,12476,4380
train/images382_png_jpg.rf.9303cd04926a51219291e796ce326944.jpg,75,183,13725,9712,4013
train/images382_png_jpg.rf.9e3412beb5c55eb0df5d4c533ac5bf78.jpg,51,189,9639,6851,2788
train/images383_png_jpg.rf.3f07c21b30c51d044f4f7f1cc0c4eb87.jpg,89,199,17711,12323,5388
train/images383_png_jpg.rf.c52bad6f3e6209ce5a373a9de11655d5.jpg,67,211,14137,9896,4241
train/images391_png_jpg.rf.7dc140b6094fa30159d3c0c786e3cd34.jpg,14,98,1372,1068,304
train/images391_png_jpg.rf.a4a901e7f393f15aa9852374fd5e53de.jpg,15,96,1440,1167,273
train/images394_png_jpg.rf.63166d74ba773647dae3cd2913d434ec.jpg,33,114,3762,3114,648
train/images394_png_jpg.rf.6336b67efd47101fdc674258001934bd.jpg,17,107,1819,1556,263
train/images396_png_jpg.rf.27ec3702a7ab9ceeab2a2f10790390d4.jpg,39,129,5031,4106,925
train/images396_png_jpg.rf.34f9c2b719872ee950b546c9d038dcc3.jpg,40,129,5160,4287,873
train/images396_png_jpg.rf.c141baa55822f044e9b6f3f0779ee459.jpg,39,124,4836,3955,881
train/images397_png_jpg.rf.793f5b9a83afbae2298e81dfb0ad0b0c.jpg,46,136,6256,5259,997
train/images397_png_jpg.rf.e1f0945d969177bed1bee9a857a3acfa.jpg,43,132,5676,4850,826
train/images398_png_jpg.rf.4e8097932a09a3d1f315c0cbf23f2e7f.jpg,49,146,7154,5993,1161
train/images398_png_jpg.rf.6ddc4f193899e1da17cb5e0f5d5f8cd7.jpg,46,140,6440,5510,930
train/images398_png_jpg.rf.e64017745e527321ccfa530359ce058d.jpg,48,145,6960,5997,963
train/images399_png_jpg.rf.263e4d9445b91e499aa84bcc53b7179a.jpg,57,153,8721,7384,1337
train/images399_png_jpg.rf.5ff07f7c7597af10ed571bbc4981e8b2.jpg,56,159,8904,7596,1308
train/images399_png_jpg.rf.5ff07f7c7597af10ed571bbc4981e8b2.jpg,34,20,680,518,162
train/images399_png_jpg.rf.7eabf8fa645268b2673b45cd95f55d6c.jpg,56,153,8568,7295,1273
train/images39_png_jpg.rf.b2cfb28bc330c80f115319d22da32d9a.jpg,82,37,3034,2058,976
train/images401_png_jpg.rf.5ad781c8df391339f03acbdb8f6b29d7.jpg,72,183,13176,10717,2459
train/images401_png_jpg.rf.bb2c9a9d07afa869ce1952ff90c258c4.jpg,69,183,12627,10662,1965
train/images401_png_jpg.rf.d16795359c4c4e7e1aa6575a46145402.jpg,76,195,14820,12154,2666
train/images403_png_jpg.rf.91af6f386bbe6d37ba5dbb5f239f52b4.jpg,51,197,10047,8391,1656
train/images403_png_jpg.rf.a9cf106cd219efbe8d6e1d9c05aa8c7c.jpg,27,167,4509,3416,1093
train/images404_png_jpg.rf.91750cdbbf690b23cb18034531f4e08b.jpg,32,190,6080,4536,1544
train/images40_png_jpg.rf.673b38877aacf9395886342f46fdc6fd.jpg,92,36,3312,2479,833
train/images40_png_jpg.rf.99326ec62b7e38b5140234a7e75e2d09.jpg,104,40,4160,2628,1532
train/images40_png_jpg.rf.99326ec62b7e38b5140234a7e75e2d09.jpg,27,69,1863,1432,431
train/images40_png_jpg.rf.9ba406b7bfa0640d132e978d896b8610.jpg,98,41,4018,2713,1305
train/images416_png_jpg.rf.b3448f19eab87c948ad236b2cc0a0906.jpg,47,98,4606,3804,802
train/images307_png_jpg.rf.68f7058217efc8a9c74b348d8b96bc89.jpg,37,126,4662,2038,2624
train/images30_png_jpg.rf.a9fcd1dfc8d492e3f23711f1e52bde5c.jpg,27,56,1512,1044,468
train/images33_png_jpg.rf.6419c14918e5330889c4856f96a076ef.jpg,104,72,7488,4761,2727
train/images380_png_jpg.rf.000c251ae72780ef2bb3ac06b95399a5.jpg,73,180,13140,9466,3674
train/images383_png_jpg.rf.fa310fed7f8a398f55cc336f61c4f635.jpg,57,197,11229,7247,3982
train/images397_png_jpg.rf.67038cfaebc2099fbd7cf132b8f65068.jpg,40,127,5080,4330,750
train/images39_png_jpg.rf.e262e67dc91443c2c86dedfb5fd81e2a.jpg,67,37,2479,1786,693
train/images429_png_jpg.rf.0ddba0f68234236312a7c9d34fa43e2f.jpg,47,134,6298,4529,1769
train/images429_png_jpg.rf.ab1aa8e8b05a5ded67dc444362ea78f4.jpg,70,136,9520,7907,1613
train/images429_png_jpg.rf.b81219a115bd5ac29489ec86d60519a5.jpg,90,133,11970,9655,2315
train/images431_png_jpg.rf.80beb2532d9a1e0afcf4c9281c2ace39.jpg,33,121,3993,2553,1440
train/images431_png_jpg.rf.813c521bfa129fab657edc55ff218b19.jpg,29,121,3509,2225,1284
train/images43_png_jpg.rf.3a2242b99a56bec4944ca6080c90b141.jpg,69,80,5520,4327,1193
train/images43_png_jpg.rf.3a2242b99a56bec4944ca6080c90b141.jpg,73,137,10001,8213,1788
train/images43_png_jpg.rf.3a2242b99a56bec4944ca6080c90b141.jpg,50,70,3500,2633,867
train/images43_png_jpg.rf.d9f19dbe0c17c9655a389f3a2cb0cdcb.jpg,67,77,5159,3978,1181
train/images43_png_jpg.rf.d9f19dbe0c17c9655a389f3a2cb0cdcb.jpg,42,54,2268,1254,1014
train/images43_png_jpg.rf.d9f19dbe0c17c9655a389f3a2cb0cdcb.jpg,107,121,12947,9092,3855
train/images43_png_jpg.rf.e240dcf993a9ad1998041e44b960625f.jpg,73,81,5913,4321,1592
train/images43_png_jpg.rf.e240dcf993a9ad1998041e44b960625f.jpg,95,129,12255,9083,3172
train/images442_png_jpg.rf.1b713fed33a311490783b9af1ce6e216.jpg,73,193,14089,10853,3236
train/images443_png_jpg.rf.c32ffa6182281fee67c55b9bab746381.jpg,29,100,2900,1913,987
train/images447_png_jpg.rf.03406ebfda4bbf40f985520af2ba7951.jpg,25,76,1900,1447,453
train/images447_png_jpg.rf.03406ebfda4bbf40f985520af2ba7951.jpg,21,69,1449,1171,278
train/images447_png_jpg.rf.ac5c6c1a92cabefd70381f0dfb567b3c.jpg,16,62,992,810,182
train/images447_png_jpg.rf.ac5c6c1a92cabefd70381f0dfb567b3c.jpg,13,64,832,686,146
train/images448_png_jpg.rf.53092b29454689251ff7d6764ee73fa4.jpg,33,90,2970,1892,1078
train/images451_png_jpg.rf.0e17702802949768b8a77c73217c2a03.jpg,24,75,1800,1346,454
train/images451_png_jpg.rf.0e17702802949768b8a77c73217c2a03.jpg,20,68,1360,1081,279
train/images451_png_jpg.rf.a738af6d1c9aaa35d0878709edd10898.jpg,22,80,1760,1343,417
train/images451_png_jpg.rf.a738af6d1c9aaa35d0878709edd10898.jpg,20,60,1200,996,204
train/images454_png_jpg.rf.ebd198c5943d087afa7590053e543bbc.jpg,24,68,1632,1269,363
train/images454_png_jpg.rf.ebd198c5943d087afa7590053e543bbc.jpg,27,79,2133,1601,532
train/images455_png_jpg.rf.a5ffb11a84d598f744cb37616624609a.jpg,36,69,2484,1966,518
train/images455_png_jpg.rf.a5ffb11a84d598f744cb37616624609a.jpg,37,84,3108,2166,942
train/images455_png_jpg.rf.bc82f07d2bcfcaa460eaaa1c447da9f0.jpg,28,71,1988,1570,418
train/images455_png_jpg.rf.bc82f07d2bcfcaa460eaaa1c447da9f0.jpg,31,81,2511,1954,557
train/images456_png_jpg.rf.789509fab4a8206c25f63a7223c66768.jpg,28,80,2240,1772,468
train/images456_png_jpg.rf.789509fab4a8206c25f63a7223c66768.jpg,24,72,1728,1375,353
train/images458_png_jpg.rf.31e3e9b98e143b5b6cd5a127292a8b42.jpg,40,83,3320,2378,942
train/images458_png_jpg.rf.31e3e9b98e143b5b6cd5a127292a8b42.jpg,39,73,2847,2041,806
train/images459_png_jpg.rf.abda91c7dd805f213dcd084866b18e63.jpg,17,72,1224,1034,190
train/images459_png_jpg.rf.abda91c7dd805f213dcd084866b18e63.jpg,22,89,1958,1512,446
train/images461_png_jpg.rf.8e56b0c4bca5343e0ae03af2ef905c87.jpg,43,85,3655,2567,1088
train/images461_png_jpg.rf.8e56b0c4bca5343e0ae03af2ef905c87.jpg,38,72,2736,2166,570
train/images461_png_jpg.rf.a1b110e5df80cb1b568210fb824bdeee.jpg,24,76,1824,1543,281
train/images461_png_jpg.rf.a1b110e5df80cb1b568210fb824bdeee.jpg,29,92,2668,2008,660
train/images46_png_jpg.rf.84fa5be964357676f7b3ccf934f59f6d.jpg,76,99,7524,5685,1839
train/images46_png_jpg.rf.84fa5be964357676f7b3ccf934f59f6d.jpg,112,135,15120,9340,5780
train/images46_png_jpg.rf.88b7605bb02bda149c1835d30a1e02fd.jpg,79,101,7979,5898,2081
train/images46_png_jpg.rf.88b7605bb02bda149c1835d30a1e02fd.jpg,95,151,14345,8812,5533
train/images46_png_jpg.rf.a5f0dec4bf1840d99b893752d8b38930.jpg,33,58,1914,1266,648
train/images46_png_jpg.rf.a5f0dec4bf1840d99b893752d8b38930.jpg,28,51,1428,1019,409
train/images46_png_jpg.rf.a5f0dec4bf1840d99b893752d8b38930.jpg,57,96,5472,3757,1715
train/images46_png_jpg.rf.a5f0dec4bf1840d99b893752d8b38930.jpg,33,41,1353,901,452
train/images46_png_jpg.rf.a5f0dec4bf1840d99b893752d8b38930.jpg,61,71,4331,2278,2053
train/images47_png_jpg.rf.1b424a1a375142f101ba9bae8e277b8e.jpg,61,100,6100,4735,1365
train/images47_png_jpg.rf.d6fb95c863e2ce8e8b6f16438cd52974.jpg,63,99,6237,4668,1569
train/images483_png_jpg.rf.6f661629a38a49b34719f97622cb95ad.jpg,37,95,3515,2011,1504
train/images483_png_jpg.rf.c92d6bd88eefcf50b71c5dffd660adbf.jpg,26,94,2444,1611,833
train/images485_png_jpg.rf.e36880a913a13d58aa80317345b27aeb.jpg,46,98,4508,2572,1936
train/images486_png_jpg.rf.44cde6aa74d1fe80a06b24200c15f816.jpg,45,98,4410,2519,1891
train/images486_png_jpg.rf.991c1ed921bfab541779ca6a6cfe4dbd.jpg,37,95,3515,2228,1287
train/images488_png_jpg.rf.687e83d83d7bff3ffac023a4381728b2.jpg,38,109,4142,2562,1580
train/images488_png_jpg.rf.b6ecae700ce695fcb52530e66c964538.jpg,35,109,3815,2480,1335
train/images48_png_jpg.rf.42d8349fbf2f09b3d5ff9801ad3fb6f4.jpg,54,72,3888,2496,1392
train/images48_png_jpg.rf.42d8349fbf2f09b3d5ff9801ad3fb6f4.jpg,92,91,8372,5364,3008
train/images48_png_jpg.rf.dacfb87a0c96946e25a626050ba488b1.jpg,51,72,3672,2422,1250
train/images48_png_jpg.rf.e816d34baa2e10ed90d187b143c00467.jpg,46,66,3036,2066,970
train/images48_png_jpg.rf.e816d34baa2e10ed90d187b143c00467.jpg,72,138,9936,5609,4327
train/images491_png_jpg.rf.6d125f87c0bafa74159fcfc69f747508.jpg,59,111,6549,3768,2781
train/images491_png_jpg.rf.7565f6b3fde973400322bf05b9608f94.jpg,42,115,4830,3244,1586
train/images491_png_jpg.rf.c1620e3ffe9b9c44db331223300b9a5d.jpg,42,111,4662,2989,1673
train/images492_png_jpg.rf.315b91ea7ada46398024df722117ea15.jpg,62,114,7068,4045,3023
train/images492_png_jpg.rf.575e7853c493bd84c10bb37606d343c8.jpg,65,121,7865,4643,3222
train/images492_png_jpg.rf.7197ecb5dc75fdf6b004e283cdb5cd86.jpg,63,114,7182,4127,3055
train/images443_png_jpg.rf.063d1fbe02dd6be0d0aae8cbe1d3399a.jpg,23,92,2116,1534,582
train/images448_png_jpg.rf.c454037a594832764d53313d936460f0.jpg,12,55,660,540,120
train/images448_png_jpg.rf.c454037a594832764d53313d936460f0.jpg,15,76,1140,863,277
train/images454_png_jpg.rf.55dc6b158d24d1171149cac5fe64d9bc.jpg,20,82,1640,1224,416
train/images454_png_jpg.rf.55dc6b158d24d1171149cac5fe64d9bc.jpg,14,64,896,782,114
train/images459_png_jpg.rf.8caeaf95a6b1544ee6f2768bd625c4bc.jpg,42,84,3528,2449,1079
train/images459_png_jpg.rf.8caeaf95a6b1544ee6f2768bd625c4bc.jpg,40,69,2760,2165,595
train/images47_png_jpg.rf.8398c1396e5aa453ee08ef8d422a7b0a.jpg,32,57,1824,1251,573
train/images47_png_jpg.rf.8398c1396e5aa453ee08ef8d422a7b0a.jpg,39,46,1794,1166,628
train/images485_png_jpg.rf.54a4f95f52d32e2530c451017cfd2bc8.jpg,43,97,4171,2402,1769
train/images494_png_jpg.rf.5cafef803b91ca8c84b41a532e42be1c.jpg,65,117,7605,4443,3162
train/images494_png_jpg.rf.88538f507b15bbf4143aedc64c94743c.jpg,56,118,6608,4160,2448
train/images494_png_jpg.rf.d4b1aff6784f23cd3daf04e285759387.jpg,66,116,7656,4335,3321
train/images495_png_jpg.rf.1b3c8633e1a2d5cbdf1ca0d5add31c48.jpg,66,127,8382,4981,3401
train/images495_png_jpg.rf.388203ddbce22284383c383dc5ffd0d7.jpg,71,123,8733,4879,3854
train/images495_png_jpg.rf.d2a08f5cb1961b850c06ca0872043ba6.jpg,68,120,8160,4609,3551
train/images496_png_jpg.rf.5cad60b116321ace3bd02d4075a273a3.jpg,72,123,8856,5174,3682
train/images496_png_jpg.rf.743cebc3097e6cf28e8fcc153e201259.jpg,74,130,9620,5709,3911
train/images496_png_jpg.rf.7b5fba1df25c5d16464655ffbbccce9b.jpg,71,123,8733,5052,3681
train/images497_png_jpg.rf.7ff8ec19dcf42514605b49ddc2710937.jpg,81,135,10935,6124,4811
train/images497_png_jpg.rf.9426eb9704792700bbd0c0737f509c2e.jpg,75,127,9525,5447,4078
train/images498_png_jpg.rf.464eacc04df4248dc6b1b413df971158.jpg,79,133,10507,6096,4411
train/images498_png_jpg.rf.9549d8bf9f6405114fbcf896efd13d26.jpg,80,133,10640,6184,4456
train/images498_png_jpg.rf.b4e7d3fdf22194ecd2170fe2f168211e.jpg,83,139,11537,6628,4909
train/images49_png_jpg.rf.1443ca752d41440487100ac1b36a3523.jpg,64,78,4992,3058,1934
train/images49_png_jpg.rf.1443ca752d41440487100ac1b36a3523.jpg,72,77,5544,3607,1937
train/images49_png_jpg.rf.1443ca752d41440487100ac1b36a3523.jpg,78,88,6864,3463,3401
train/images49_png_jpg.rf.1443ca752d41440487100ac1b36a3523.jpg,27,52,1404,1091,313
train/images49_png_jpg.rf.3b9e37bddd0e06de9594919f02d45da3.jpg,58,73,4234,2694,1540
train/images49_png_jpg.rf.3b9e37bddd0e06de9594919f02d45da3.jpg,77,75,5775,3118,2657
train/images49_png_jpg.rf.4ae314b2f5d321124e77f8b8b9f1ee67.jpg,54,77,4158,2760,1398
train/images49_png_jpg.rf.4ae314b2f5d321124e77f8b8b9f1ee67.jpg,55,55,3025,2112,913
train/images49_png_jpg.rf.4ae314b2f5d321124e77f8b8b9f1ee67.jpg,56,79,4424,2963,1461
train/images500_png_jpg.rf.03e96fbaf100249cbe2ef9ed87ffb654.jpg,85,137,11645,6735,4910
train/images500_png_jpg.rf.76e75acaade3b9a97f5b59d1f5a8b097.jpg,91,149,13559,7669,5890
train/images501_png_jpg.rf.1fd26f3bf2dbbedcebe269a375402345.jpg,74,147,10878,6781,4097
train/images501_png_jpg.rf.9e24af218c00a449c1393d68e74970ee.jpg,81,145,11745,7433,4312
train/images501_png_jpg.rf.d4d42a821dd74461ef8eba1be8bb04ca.jpg,97,152,14744,8315,6429
train/images502_png_jpg.rf.0db8efb375cc840242a7687c1eca98cd.jpg,94,150,14100,7985,6115
train/images502_png_jpg.rf.33c954116dbb4e3905147765b13c7053.jpg,92,156,14352,8449,5903
train/images502_png_jpg.rf.3d23f1dde4f823a16ff8d87a6260f8f2.jpg,96,152,14592,8252,6340
train/images505_png_jpg.rf.c48c64bbaa31e60ceb3efdff745e0fe0.jpg,34,54,1836,1316,520
train/images506_png_jpg.rf.3ca964d0a8b68e870070d5f6cff929de.jpg,37,58,2146,1387,759
train/images506_png_jpg.rf.3ca964d0a8b68e870070d5f6cff929de.jpg,23,44,1012,859,153
train/images506_png_jpg.rf.cc76b2a1f468692e9eb4d1769dae4536.jpg,58,78,4524,2568,1956
train/images506_png_jpg.rf.cc76b2a1f468692e9eb4d1769dae4536.jpg,42,75,3150,2484,666
train/images508_png_jpg.rf.8c4378fd6d261011209ab2b0685d08be.jpg,37,54,1998,1406,592
train/images508_png_jpg.rf.a7e5d2a2407742e9682bf8b3656d54d6.jpg,33,54,1782,1271,511
train/images508_png_jpg.rf.eb517eddd657c9e92201e51cbfd60601.jpg,37,58,2146,1483,663
train/images50_png_jpg.rf.5d2aacd87c07a8de2e165bd2c4f8821c.jpg,123,189,23247,11433,11814
train/images50_png_jpg.rf.5d2aacd87c07a8de2e165bd2c4f8821c.jpg,65,84,5460,3388,2072
train/images50_png_jpg.rf.709a5d4bd8c66b0af8c4e6d3246cb405.jpg,116,191,22156,11243,10913
train/images50_png_jpg.rf.709a5d4bd8c66b0af8c4e6d3246cb405.jpg,59,87,5133,3312,1821
train/images50_png_jpg.rf.de313624c9f901f8d3277d011b3dcaf2.jpg,62,85,5270,3333,1937
train/images50_png_jpg.rf.de313624c9f901f8d3277d011b3dcaf2.jpg,105,169,17745,8931,8814
train/images510_png_jpg.rf.c6e25426dbf943a6ff93ad940b29e5c7.jpg,43,143,6149,4995,1154
train/images510_png_jpg.rf.c6e25426dbf943a6ff93ad940b29e5c7.jpg,59,130,7670,4516,3154
train/images517_png_jpg.rf.39468f1846d0c61c7dca03efbdf0519d.jpg,54,80,4320,2367,1953
train/images517_png_jpg.rf.39468f1846d0c61c7dca03efbdf0519d.jpg,38,81,3078,2213,865
train/images517_png_jpg.rf.69b9f4e08403546018ced77333f9d504.jpg,81,82,6642,3853,2789
train/images517_png_jpg.rf.69b9f4e08403546018ced77333f9d504.jpg,74,69,5106,3953,1153
train/images517_png_jpg.rf.c03b6925262b305890df039e3829e3eb.jpg,50,65,3250,2035,1215
train/images517_png_jpg.rf.c03b6925262b305890df039e3829e3eb.jpg,32,78,2496,1695,801
train/images51_png_jpg.rf.41a5743116b1b6bd5f3295aa63deaa1d.jpg,147,213,31311,15736,15575
train/images51_png_jpg.rf.41a5743116b1b6bd5f3295aa63deaa1d.jpg,78,92,7176,4601,2575
train/images51_png_jpg.rf.f523f34c3aa9e82fb2b49ec72dc8689f.jpg,159,213,33867,16087,17780
train/images51_png_jpg.rf.f523f34c3aa9e82fb2b49ec72dc8689f.jpg,76,102,7752,4766,2986
train/images522_png_jpg.rf.974b34ff9ffaa6eb3812cbac7c7d13bf.jpg,36,125,4500,3190,1310
train/images522_png_jpg.rf.d624ad9f05206fa7ef2373d449d53340.jpg,35,122,4270,2998,1272
train/images522_png_jpg.rf.e946824aca886965da5592450af986a5.jpg,34,117,3978,2812,1166
train/images52_png_jpg.rf.135c6249286cd4d010efc1d13f17e354.jpg,96,227,21792,13529,8263
train/images52_png_jpg.rf.69bc8aa6b79044bb32bfb099c3841ed3.jpg,105,234,24570,16020,8550
train/images52_png_jpg.rf.69bc8aa6b79044bb32bfb099c3841ed3.jpg,35,74,2590,1646,944
train/images52_png_jpg.rf.f9fe1a4c74655aa5c1924f2f0df45ca6.jpg,130,225,29250,16088,13162
train/images52_png_jpg.rf.f9fe1a4c74655aa5c1924f2f0df45ca6.jpg,58,72,4176,3154,1022
train/images530_png_jpg.rf.2794973b6c3c3f0b4fe1dc10c77f9a28.jpg,55,162,8910,7354,1556
train/images530_png_jpg.rf.2794973b6c3c3f0b4fe1dc10c77f9a28.jpg,58,159,9222,6343,2879
train/images530_png_jpg.rf.38279ea514d30733890d82ab3b33458e.jpg,48,160,7680,6371,1309
train/images530_png_jpg.rf.38279ea514d30733890d82ab3b33458e.jpg,58,154,8932,6215,2717
train/images530_png_jpg.rf.cbd874af9d6dea293ecaa2a8247fbf77.jpg,68,165,11220,9120,2100
train/images530_png_jpg.rf.cbd874af9d6dea293ecaa2a8247fbf77.jpg,59,152,8968,6210,2758
train/images532_png_jpg.rf.0aedfba7f8b9b2f96592e1d7295b72c9.jpg,45,96,4320,3034,1286
train/images532_png_jpg.rf.0aedfba7f8b9b2f96592e1d7295b72c9.jpg,39,82,3198,2541,657
train/images532_png_jpg.rf.0aedfba7f8b9b2f96592e1d7295b72c9.jpg,22,27,594,477,117
train/images532_png_jpg.rf.6318b72135edb4188a2edf919d45e129.jpg,50,96,4800,3275,1525
train/images532_png_jpg.rf.6318b72135edb4188a2edf919d45e129.jpg,50,78,3900,2951,949
train/images532_png_jpg.rf.deb93de00c98e7ef970dca3e80c5d892.jpg,47,91,4277,3061,1216
train/images532_png_jpg.rf.deb93de00c98e7ef970dca3e80c5d892.jpg,48,79,3792,2736,1056
train/images533_png_jpg.rf.3e6fe46e23686f2d45836679ee9e44c7.jpg,93,110,10230,6953,3277
train/images533_png_jpg.rf.3e6fe46e23686f2d45836679ee9e44c7.jpg,75,120,9000,6695,2305
train/images533_png_jpg.rf.6ee90237f57d2d783805be32421ab5d0.jpg,68,130,8840,6439,2401
train/images533_png_jpg.rf.6ee90237f57d2d783805be32421ab5d0.jpg,77,116,8932,6415,2517
train/images533_png_jpg.rf.c81adebe94b37ff338f0e71edf1e814d.jpg,103,113,11639,7785,3854
train/images533_png_jpg.rf.c81adebe94b37ff338f0e71edf1e814d.jpg,82,123,10086,7274,2812
train/images535_png_jpg.rf.43422e58136623f6df7a36eb570ccb64.jpg,69,74,5106,3056,2050
train/images535_png_jpg.rf.db013b3aa434ec39caf7f92a10f7e0ee.jpg,69,77,5313,3189,2124
train/images538_png_jpg.rf.5b094a9a2d935494a002004c9df50863.jpg,74,84,6216,4793,1423
train/images538_png_jpg.rf.5b094a9a2d935494a002004c9df50863.jpg,30,46,1380,916,464
train/images538_png_jpg.rf.be97b45ad3229a42484bf236f9aaeaa0.jpg,77,85,6545,4933,1612
train/images538_png_jpg.rf.fd889761d8baeece8404170c9404bc87.jpg,67,91,6097,4770,1327
train/images538_png_jpg.rf.fd889761d8baeece8404170c9404bc87.jpg,47,48,2256,1654,602
train/images539_png_jpg.rf.4b7fbea89987d79d77d438729078aa26.jpg,55,69,3795,3023,772
train/images539_png_jpg.rf.b2986cbd22264619d9637bcb24daa45b.jpg,50,73,3650,2891,759
train/images53_png_jpg.rf.66d1642781f69a027281b565fc1d88b4.jpg,126,274,34524,22179,12345
train/images53_png_jpg.rf.a43f96d18e10de3f386e4e0f4cf0b0eb.jpg,55,214,11770,5012,6758
train/images53_png_jpg.rf.e5a44c73224f8d5efe157714af1c2102.jpg,68,196,13328,8146,5182
train/images541_png_jpg.rf.0923e77637ce4050d678ae45fb6e797e.jpg,35,60,2100,1807,293
train/images543_png_jpg.rf.9979f2ec19e44bd1005a3450fcb74ad0.jpg,53,167,8851,6954,1897
train/images544_png_jpg.rf.559ae27cc973db1afc85bb931ae73b22.jpg,50,116,5800,4123,1677
train/images544_png_jpg.rf.85b8c5eb5cd044e9baf594f1fb91fb86.jpg,52,115,5980,4310,1670
train/images544_png_jpg.rf.bae80bf022bef880567894aed4816476.jpg,53,114,6042,4119,1923
train/images545_png_jpg.rf.9422c4146a61435bc043beb3ef162616.jpg,59,158,9322,6591,2731
train/images545_png_jpg.rf.ec6f3a124a428c15d64b8a450fa7bed4.jpg,30,140,4200,2349,1851
train/images554_png_jpg.rf.171fe291805b2635ee18dd338927f19c.jpg,36,106,3816,2875,941
train/images554_png_jpg.rf.39d80f5f29a22b10d4ab488c7c5b825b.jpg,34,98,3332,2512,820
train/images554_png_jpg.rf.5d9fb71269c1ff14cdf3ac899cad76f3.jpg,32,83,2656,2233,423
train/images555_png_jpg.rf.c2d1f6af6d8039234dbbdf738c6b2f1f.jpg,38,106,4028,3003,1025
train/images555_png_jpg.rf.d7dcab91ce0d1b5aa8dbe37458dd1f66.jpg,33,82,2706,2333,373
train/images497_png_jpg.rf.71642306911cd98a561690c94f3306a7.jpg,77,133,10241,5915,4326
train/images500_png_jpg.rf.790ddc0df1c98cfa0f7f7cba7168e918.jpg,89,150,13350,7689,5661
train/images506_png_jpg.rf.4d53147f26157bad7c8c79f777f04192.jpg,41,57,2337,1532,805
train/images506_png_jpg.rf.4d53147f26157bad7c8c79f777f04192.jpg,22,78,1716,1216,500
train/images51_png_jpg.rf.f49eaf8cc904235e1085e4e3c041117c.jpg,132,211,27852,14132,13720
train/images51_png_jpg.rf.f49eaf8cc904235e1085e4e3c041117c.jpg,65,96,6240,4045,2195
train/images535_png_jpg.rf.f6fa8353d8cdba30e9e9f271b1611f3e.jpg,67,76,5092,3048,2044
train/images545_png_jpg.rf.43fe4b5810945a16214f12c2e0b6a6c4.jpg,57,162,9234,6835,2399
train/images556_png_jpg.rf.3bebac3b327cca7f388e9dc046255185.jpg,37,99,3663,2809,854
train/images556_png_jpg.rf.7178dd8845f9419bbad524eb846a83aa.jpg,37,54,1998,1578,420
train/images556_png_jpg.rf.c5560c70e7967ecc085f53680fa2faa8.jpg,38,95,3610,2807,803
train/images557_png_jpg.rf.88c0a197bbfde6ec06e56824c9687265.jpg,33,31,1023,806,217
train/images557_png_jpg.rf.a10ed2a39f71f26bf64e3e13cadbe289.jpg,38,87,3306,2711,595
train/images557_png_jpg.rf.a10ed2a39f71f26bf64e3e13cadbe289.jpg,21,84,1764,1314,450
train/images557_png_jpg.rf.f51569a120a8d2e8f6d2b93fc123172b.jpg,40,87,3480,2844,636
train/images558_png_jpg.rf.102174227fce53ff6eed5de06fdfcad2.jpg,65,84,5460,3191,2269
train/images558_png_jpg.rf.102174227fce53ff6eed5de06fdfcad2.jpg,51,81,4131,3099,1032
train/images558_png_jpg.rf.49213fa5fa69dcda811cd5b1029fd5b0.jpg,26,47,1222,779,443
train/images558_png_jpg.rf.49213fa5fa69dcda811cd5b1029fd5b0.jpg,27,13,351,271,80
train/images558_png_jpg.rf.bd19ad45b5f1d81164211a8c42a2ec5d.jpg,63,81,5103,2876,2227
train/images558_png_jpg.rf.bd19ad45b5f1d81164211a8c42a2ec5d.jpg,48,78,3744,2842,902
train/images560_png_jpg.rf.3e6a9f231943b7b0cfa1fa89cab1c88f.jpg,36,20,720,523,197
train/images562_png_jpg.rf.bce3d065b8809ab8a44ec1e33411f7ff.jpg,22,87,1914,1557,357
train/images564_png_jpg.rf.7e0c99cd002716d25f8e8f82725b640e.jpg,21,97,2037,1629,408
train/images564_png_jpg.rf.91bc2025882f72816a37bc665825420a.jpg,20,100,2000,1397,603
train/images571_png_jpg.rf.2a5a2efc0a39b211018a5301a497a7a3.jpg,59,121,7139,5797,1342
train/images571_png_jpg.rf.5694b8512c0c8aa69029c7bd74d10aba.jpg,58,120,6960,5696,1264
train/images571_png_jpg.rf.ce0878f0b899c20a28fb024cb08db5d6.jpg,61,119,7259,6291,968
train/images572_png_jpg.rf.a8a98a7839cc374715f12b48a9b1053b.jpg,66,102,6732,5812,920
train/images572_png_jpg.rf.ed160e4441da1a7eeda4d8716e194db2.jpg,65,127,8255,6683,1572
train/images573_png_jpg.rf.0e63744b3ace2aaa1744f4fbe1445945.jpg,52,137,7124,5704,1420
train/images573_png_jpg.rf.49b89a324454c266a4872fe115d13d23.jpg,66,133,8778,7124,1654
train/images573_png_jpg.rf.f9cc870cdae8bee4c19c08391ab5988e.jpg,68,89,6052,5135,917
train/images607_png_jpg.rf.d70ad250632940397323c3cd36d74efd.jpg,25,106,2650,1904,746
train/images609_png_jpg.rf.4be1d9c56bab0e725691784d47ce2f45.jpg,29,100,2900,1961,939
train/images610_png_jpg.rf.9fedbc81653716a2845b2ff709d84742.jpg,24,99,2376,1655,721
train/images612_png_jpg.rf.4bf35ed24f93282385d4e309dcda4033.jpg,24,97,2328,1659,669
train/images613_png_jpg.rf.538f52cf88ecada7531858f764483587.jpg,42,111,4662,3397,1265
train/images614_png_jpg.rf.62693d07fc61607fabd8e11f16db9732.jpg,20,69,1380,1018,362
train/images648_png_jpg.rf.8d2a2fdd798033a0c734d546e2cbf1f7.jpg,64,124,7936,6040,1896
train/images648_png_jpg.rf.b7719ee24010a214cdb8fe6a946290f5.jpg,47,145,6815,4881,1934
train/images648_png_jpg.rf.df7ad6d6bca31ace37c1b51508c15dc6.jpg,59,132,7788,5649,2139
train/images656_png_jpg.rf.3c10afb2c26f9f4bb94d270639742745.jpg,96,146,14016,9744,4272
train/images656_png_jpg.rf.7ba37d7dadd4331235a545df7f9dd9ff.jpg,89,138,12282,9214,3068
train/images656_png_jpg.rf.f2ff802697913f6efdbc8e3ccc4c11fc.jpg,58,141,8178,5940,2238
train/images658_png_jpg.rf.9ba601cc7a72e94afdd40d9c7c390182.jpg,57,136,7752,5788,1964
train/images658_png_jpg.rf.aeeb73551ca97dff55c9044e4305ccaf.jpg,78,142,11076,8391,2685
train/images658_png_jpg.rf.ff9bdf6288d57dd1559b73d63e37c250.jpg,93,135,12555,9214,3341
train/images65_png_jpg.rf.08b4a037347827268447cb415031f28c.jpg,73,52,3796,3061,735
train/images65_png_jpg.rf.cfc2d2fc256318a658d70b00bf59bc9d.jpg,94,49,4606,3712,894
train/images663_png_jpg.rf.156a54828fdc290ee167f75ea941ece9.jpg,59,134,7906,6001,1905
train/images663_png_jpg.rf.156a54828fdc290ee167f75ea941ece9.jpg,47,131,6157,4175,1982
train/images663_png_jpg.rf.a1d3d65c1a2325b5f48d953d46711aa5.jpg,59,139,8201,6285,1916
train/images663_png_jpg.rf.a1d3d65c1a2325b5f48d953d46711aa5.jpg,40,128,5120,3904,1216
train/images663_png_jpg.rf.d07c5741fee1232753087f83580bdb98.jpg,69,150,10350,7283,3067
train/images666_png_jpg.rf.192bdd6a4e96bfb6953f3c68f7c198da.jpg,64,144,9216,6911,2305
train/images666_png_jpg.rf.192bdd6a4e96bfb6953f3c68f7c198da.jpg,51,140,7140,4714,2426
train/images666_png_jpg.rf.688a62bc0120d900362b791b6fc3c6bc.jpg,62,143,8866,6737,2129
train/images666_png_jpg.rf.688a62bc0120d900362b791b6fc3c6bc.jpg,49,136,6664,4503,2161
train/images666_png_jpg.rf.80e2c5e419ab91cc8e024f5ea8041091.jpg,62,138,8556,6528,2028
train/images666_png_jpg.rf.80e2c5e419ab91cc8e024f5ea8041091.jpg,48,134,6432,4423,2009
train/images560_png_jpg.rf.9e2c352225fff0aacd3b2b7aed71dfa0.jpg,40,52,2080,1742,338
train/images560_png_jpg.rf.9e2c352225fff0aacd3b2b7aed71dfa0.jpg,22,88,1936,1492,444
train/images572_png_jpg.rf.9c05a5de63f7156f00431dc3c4057277.jpg,64,135,8640,6815,1825
train/images65_png_jpg.rf.9bfd3907f2b9684e63b7424e540b03f1.jpg,97,51,4947,3903,1044
train/images670_png_jpg.rf.79bfa92b5def8e7550fccc2f234bf363.jpg,67,146,9782,7400,2382
train/images670_png_jpg.rf.79bfa92b5def8e7550fccc2f234bf363.jpg,49,139,6811,4758,2053
train/images670_png_jpg.rf.7fe435c7d25fb01d16b1ff5cda28cf95.jpg,66,153,10098,7924,2174
train/images670_png_jpg.rf.7fe435c7d25fb01d16b1ff5cda28cf95.jpg,54,140,7560,5121,2439
train/images671_png_jpg.rf.45aa638499387f42f24abf0c651caae6.jpg,73,152,11096,8220,2876
train/images671_png_jpg.rf.45aa638499387f42f24abf0c651caae6.jpg,53,140,7420,5159,2261
train/images671_png_jpg.rf.9c2c6db82f656cd057d276add55a421b.jpg,75,159,11925,9136,2789
train/images671_png_jpg.rf.9c2c6db82f656cd057d276add55a421b.jpg,55,146,8030,5462,2568
train/images671_png_jpg.rf.cab15ecd8418a6511fa2b9b7577f11c7.jpg,75,166,12450,9231,3219
train/images671_png_jpg.rf.cab15ecd8418a6511fa2b9b7577f11c7.jpg,56,152,8512,5659,2853
train/images676_png_jpg.rf.25f64d110d6245fc84b762b90b290287.jpg,58,147,8526,5862,2664
train/images676_png_jpg.rf.67e384160800e26d8dedef4280a73057.jpg,59,164,9676,7961,1715
train/images676_png_jpg.rf.67e384160800e26d8dedef4280a73057.jpg,61,156,9516,6371,3145
train/images676_png_jpg.rf.ab85542469ec2c88179167c3a41abaa4.jpg,48,167,8016,6456,1560
train/images676_png_jpg.rf.ab85542469ec2c88179167c3a41abaa4.jpg,62,158,9796,6753,3043
train/images677_png_jpg.rf.54b9a543e729591ed50a8e7c332ebee9.jpg,67,169,11323,9392,1931
train/images677_png_jpg.rf.54b9a543e729591ed50a8e7c332ebee9.jpg,62,159,9858,6720,3138
train/images677_png_jpg.rf.8e35686875e3891098f930fb965e08e3.jpg,49,168,8232,6566,1666
train/images677_png_jpg.rf.8e35686875e3891098f930fb965e08e3.jpg,62,161,9982,7028,2954
train/images678_png_jpg.rf.78788bb9bd15958054c829e92b8019dd.jpg,42,160,6720,5415,1305
train/images678_png_jpg.rf.78788bb9bd15958054c829e92b8019dd.jpg,61,162,9882,6649,3233
train/images678_png_jpg.rf.aa91bedcba124583234031fbcd50f1f7.jpg,50,162,8100,6644,1456
train/images678_png_jpg.rf.aa91bedcba124583234031fbcd50f1f7.jpg,60,156,9360,6561,2799
train/images678_png_jpg.rf.ec70ce289f56cf23eb7dbed886524560.jpg,61,158,9638,6766,2872
train/images679_png_jpg.rf.eb3fe270f971d6e8e3107cc359e8597a.jpg,64,165,10560,7149,3411
train/images679_png_jpg.rf.f99c8cfd4601b6efab28ed3d712f53bc.jpg,65,164,10660,7199,3461
train/images679_png_jpg.rf.fdc42a38e3ec03723e54e5967950002c.jpg,61,149,9089,6342,2747
train/images680_png_jpg.rf.120b6029b84e9463b1b211ecff462e9e.jpg,66,157,10362,7106,3256
train/images680_png_jpg.rf.120b6029b84e9463b1b211ecff462e9e.jpg,41,179,7339,5373,1966
train/images680_png_jpg.rf.a929f777701fcebcee2a966d28d1544f.jpg,44,168,7392,5740,1652
train/images680_png_jpg.rf.a929f777701fcebcee2a966d28d1544f.jpg,65,165,10725,7283,3442
train/images680_png_jpg.rf.f144cc0ee77d43f7a149a709e77bc7d9.jpg,66,173,11418,7645,3773
train/images680_png_jpg.rf.f144cc0ee77d43f7a149a709e77bc7d9.jpg,36,168,6048,4229,1819
train/images682_png_jpg.rf.ad5ca95f37e3ff9aa5b9ddb1cc68a834.jpg,69,171,11799,7885,3914
train/images682_png_jpg.rf.d5e20b37d2dfda018f642320dfe95ee6.jpg,63,159,10017,7161,2856
train/images684_png_jpg.rf.0c8623592dd5258356bcf500dfcdfb04.jpg,72,175,12600,9162,3438
train/images684_png_jpg.rf.8426efbf26a5bd4806769496e2b3f3a1.jpg,45,190,8550,5980,2570
train/images684_png_jpg.rf.e92d6e1ca88f0df854e7be63434c5b50.jpg,71,177,12567,9138,3429
train/images686_png_jpg.rf.3c075e32282d1e5adc6b344c1cb48850.jpg,40,193,7720,5076,2644
train/images686_png_jpg.rf.7ca93739093ca478eb51e42c452aa0c6.jpg,75,185,13875,9249,4626
train/images686_png_jpg.rf.7ca93739093ca478eb51e42c452aa0c6.jpg,20,118,2360,1686,674
train/images686_png_jpg.rf.ffac50b92fb73395040d12a9f824dedd.jpg,60,183,10980,8012,2968
train/images687_png_jpg.rf.4dc6b04f84258eb32f89a75ba16171dc.jpg,73,168,12264,8468,3796
train/images687_png_jpg.rf.ffd68a8dbc900d0bb6ea73219f21b809.jpg,42,199,8358,5433,2925
train/images691_png_jpg.rf.1848063ddd78fb0db07eb337d8daa96f.jpg,57,207,11799,8327,3472
train/images691_png_jpg.rf.6ef482e449c869966a1d33b3d41025f3.jpg,47,200,9400,6475,2925
train/images691_png_jpg.rf.7cbc9a1bf020dc0657ed928c094cc7c2.jpg,24,92,2208,1635,573
train/images694_png_jpg.rf.10c62d692b7e2a170072b03897530055.jpg,54,195,10530,7338,3192
train/images694_png_jpg.rf.66bd499d22524572d709f96a734f43e2.jpg,35,167,5845,3207,2638
train/images697_png_jpg.rf.399d4350d68ef7a49a24b6184f43fa75.jpg,42,97,4074,2902,1172
train/images697_png_jpg.rf.399d4350d68ef7a49a24b6184f43fa75.jpg,35,80,2800,2154,646
train/images697_png_jpg.rf.959a9f91e09c5cd7c29947db547d5507.jpg,52,81,4212,2976,1236
train/images697_png_jpg.rf.959a9f91e09c5cd7c29947db547d5507.jpg,48,93,4464,3181,1283
train/images697_png_jpg.rf.d313ffe1f5d3687a8749006b60c27d09.jpg,44,97,4268,2985,1283
train/images697_png_jpg.rf.d313ffe1f5d3687a8749006b60c27d09.jpg,39,82,3198,2491,707
train/images697_png_jpg.rf.d313ffe1f5d3687a8749006b60c27d09.jpg,26,69,1794,1418,376
train/images698_png_jpg.rf.4263d8d4336cf1723f189052df39dda6.jpg,35,77,2695,2164,531
train/images698_png_jpg.rf.4263d8d4336cf1723f189052df39dda6.jpg,40,96,3840,2702,1138
train/images698_png_jpg.rf.4263d8d4336cf1723f189052df39dda6.jpg,19,57,1083,851,232
train/images698_png_jpg.rf.59bb0e701eb10e3f0de0632f398a554d.jpg,51,95,4845,3320,1525
train/images698_png_jpg.rf.59bb0e701eb10e3f0de0632f398a554d.jpg,54,79,4266,3137,1129
train/images698_png_jpg.rf.9bdf2e99d4ec786dddd389d0c7732609.jpg,47,91,4277,3026,1251
train/images698_png_jpg.rf.9bdf2e99d4ec786dddd389d0c7732609.jpg,51,80,4080,2907,1173
train/images699_png_jpg.rf.0a6641b4a323c9284d85031cef23a948.jpg,52,97,5044,3543,1501
train/images699_png_jpg.rf.0a6641b4a323c9284d85031cef23a948.jpg,56,83,4648,3356,1292
train/images699_png_jpg.rf.7a732a7a5b18fb895852d87594db08d4.jpg,49,93,4557,3153,1404
train/images699_png_jpg.rf.7a732a7a5b18fb895852d87594db08d4.jpg,51,75,3825,2906,919
train/images699_png_jpg.rf.ca06f1392281a6a40c93fa4f1a1a90de.jpg,52,95,4940,3484,1456
train/images699_png_jpg.rf.ca06f1392281a6a40c93fa4f1a1a90de.jpg,58,83,4814,3338,1476
train/images6_png_jpg.rf.b4bd4d29d4394dc1f500d11f78af25aa.jpg,53,87,4611,3157,1454
train/images700_png_jpg.rf.18767fc17d14b737baae2615f9bec2e6.jpg,40,100,4000,2851,1149
train/images700_png_jpg.rf.18767fc17d14b737baae2615f9bec2e6.jpg,37,83,3071,2314,757
train/images700_png_jpg.rf.18767fc17d14b737baae2615f9bec2e6.jpg,21,49,1029,794,235
train/images700_png_jpg.rf.7ec64c06ccf1b7ecc8aa215b2e791a38.jpg,52,95,4940,3462,1478
train/images700_png_jpg.rf.7ec64c06ccf1b7ecc8aa215b2e791a38.jpg,57,81,4617,3322,1295
train/images700_png_jpg.rf.be0c933b2f29a26af03926371a8875d6.jpg,53,94,4982,3510,1472
train/images700_png_jpg.rf.be0c933b2f29a26af03926371a8875d6.jpg,56,83,4648,3273,1375
train/images702_png_jpg.rf.4780fb0482d8261079076e655fbceb5b.jpg,63,87,5481,4037,1444
train/images702_png_jpg.rf.4780fb0482d8261079076e655fbceb5b.jpg,60,103,6180,4085,2095
train/images702_png_jpg.rf.586a572cb4ff9f81b37a58d74555beb4.jpg,55,97,5335,3792,1543
train/images702_png_jpg.rf.586a572cb4ff9f81b37a58d74555beb4.jpg,62,82,5084,3625,1459
train/images702_png_jpg.rf.d68d6d8cf8b184855c5efea4824b94a1.jpg,56,100,5600,3862,1738
train/images702_png_jpg.rf.d68d6d8cf8b184855c5efea4824b94a1.jpg,64,84,5376,3773,1603
train/images703_png_jpg.rf.752fee65525fb0e90d411634fd0ca634.jpg,55,98,5390,3823,1567
train/images703_png_jpg.rf.752fee65525fb0e90d411634fd0ca634.jpg,62,85,5270,3759,1511
train/images703_png_jpg.rf.c285e98293c96dda9d7a9c44c0c96fec.jpg,59,105,6195,4398,1797
train/images703_png_jpg.rf.c285e98293c96dda9d7a9c44c0c96fec.jpg,68,90,6120,4377,1743
train/images703_png_jpg.rf.f11261ed8ff9cd2a61178dc5b50528b9.jpg,49,104,5096,3732,1364
train/images703_png_jpg.rf.f11261ed8ff9cd2a61178dc5b50528b9.jpg,47,85,3995,3107,888
train/images704_png_jpg.rf.565170312f3287fe3b9217ccbd3a6b87.jpg,57,102,5814,4056,1758
train/images704_png_jpg.rf.565170312f3287fe3b9217ccbd3a6b87.jpg,63,86,5418,3892,1526
train/images704_png_jpg.rf.820496b0a2e41e3a987c4a6d4fa3f73f.jpg,63,87,5481,3928,1553
train/images704_png_jpg.rf.820496b0a2e41e3a987c4a6d4fa3f73f.jpg,58,100,5800,4015,1785
train/images705_png_jpg.rf.13b7c04792bb05798aad594acfe4d7c1.jpg,60,101,6060,4290,1770
train/images705_png_jpg.rf.13b7c04792bb05798aad594acfe4d7c1.jpg,65,86,5590,4065,1525
train/images705_png_jpg.rf.5d9d69190b777953d11001f9e9130b64.jpg,73,95,6935,4853,2082
train/images705_png_jpg.rf.5d9d69190b777953d11001f9e9130b64.jpg,63,111,6993,4957,2036
train/images705_png_jpg.rf.fa417c3b105da468a89f5a820f6239ee.jpg,62,103,6386,4487,1899
train/images705_png_jpg.rf.fa417c3b105da468a89f5a820f6239ee.jpg,68,90,6120,4426,1694
train/images709_png_jpg.rf.1dfe50203eb692f5c8a2bfbad8d74a08.jpg,64,110,7040,5128,1912
train/images709_png_jpg.rf.1dfe50203eb692f5c8a2bfbad8d74a08.jpg,75,96,7200,5185,2015
train/images709_png_jpg.rf.58490067617233171f74db988a821c5d.jpg,62,106,6572,4853,1719
train/images709_png_jpg.rf.58490067617233171f74db988a821c5d.jpg,75,96,7200,5008,2192
train/images710_png_jpg.rf.14618c08853d5958dc7d89829e3f8f7c.jpg,66,110,7260,5177,2083
train/images710_png_jpg.rf.14618c08853d5958dc7d89829e3f8f7c.jpg,77,97,7469,5178,2291
train/images710_png_jpg.rf.4f8dcb19a9aefafd422d81107b2536d1.jpg,67,108,7236,5275,1961
train/images710_png_jpg.rf.4f8dcb19a9aefafd422d81107b2536d1.jpg,83,99,8217,5558,2659
train/images710_png_jpg.rf.f6809c96d3d7923bee683171f5b51f27.jpg,65,109,7085,5045,2040
train/images710_png_jpg.rf.f6809c96d3d7923bee683171f5b51f27.jpg,78,93,7254,5075,2179
train/images711_png_jpg.rf.09a166551970dc7a62fafaaf5aaef7f9.jpg,65,110,7150,5203,1947
train/images711_png_jpg.rf.09a166551970dc7a62fafaaf5aaef7f9.jpg,81,97,7857,5387,2470
train/images711_png_jpg.rf.3819903648b42cef921dbcea9e72d022.jpg,71,105,7455,5533,1922
train/images711_png_jpg.rf.3819903648b42cef921dbcea9e72d022.jpg,63,127,8001,5734,2267
train/images711_png_jpg.rf.682ce6a5b841fc1c3aafc894265e8863.jpg,67,116,7772,5676,2096
train/images711_png_jpg.rf.682ce6a5b841fc1c3aafc894265e8863.jpg,81,102,8262,5828,2434
train/images713_png_jpg.rf.5d9e24204052317bccefc3043a7d2855.jpg,71,117,8307,6015,2292
train/images713_png_jpg.rf.5d9e24204052317bccefc3043a7d2855.jpg,87,103,8961,6127,2834
train/images713_png_jpg.rf.6197e320e121a6bfa5f9f611c8d151ea.jpg,71,111,7881,5731,2150
train/images713_png_jpg.rf.6197e320e121a6bfa5f9f611c8d151ea.jpg,87,102,8874,6124,2750
train/images713_png_jpg.rf.ecb67cd828f771661886c8fcf3510238.jpg,75,109,8175,5886,2289
train/images713_png_jpg.rf.ecb67cd828f771661886c8fcf3510238.jpg,66,128,8448,6082,2366
train/images714_png_jpg.rf.1667d7093b5a9da5de21f4a11201efad.jpg,69,112,7728,5244,2484
train/images714_png_jpg.rf.1667d7093b5a9da5de21f4a11201efad.jpg,57,123,7011,5235,1776
train/images714_png_jpg.rf.e3b14892fd4e9a1ccf5edbb58e1973f4.jpg,74,105,7770,5683,2087
train/images714_png_jpg.rf.e3b14892fd4e9a1ccf5edbb58e1973f4.jpg,69,129,8901,6029,2872
train/images715_png_jpg.rf.1bd9d3b099d536f0f8af081839343d28.jpg,75,124,9300,6773,2527
train/images715_png_jpg.rf.1bd9d3b099d536f0f8af081839343d28.jpg,86,109,9374,6718,2656
train/images715_png_jpg.rf.8181c6531408ed78b682af5b88aa0a42.jpg,74,120,8880,6534,2346
train/images715_png_jpg.rf.8181c6531408ed78b682af5b88aa0a42.jpg,92,106,9752,6523,3229
train/images715_png_jpg.rf.aa7bf26291a90370f02e1810721aa7e2.jpg,73,116,8468,6335,2133
train/images715_png_jpg.rf.aa7bf26291a90370f02e1810721aa7e2.jpg,96,107,10272,6777,3495
train/images716_png_jpg.rf.28b92794c340f1e31164d57ea09a3d18.jpg,74,117,8658,6034,2624
train/images716_png_jpg.rf.28b92794c340f1e31164d57ea09a3d18.jpg,63,125,7875,5893,1982
train/images716_png_jpg.rf.5f2d2b0f81193eb8636f6a93d432d234.jpg,75,113,8475,6108,2367
train/images716_png_jpg.rf.5f2d2b0f81193eb8636f6a93d432d234.jpg,69,133,9177,6345,2832
train/images716_png_jpg.rf.6c4a970c494335416299b697a0d6a1ec.jpg,57,127,7239,5088,2151
train/images716_png_jpg.rf.6c4a970c494335416299b697a0d6a1ec.jpg,67,112,7504,5023,2481
train/images717_png_jpg.rf.247c8da4b417997b7adf036cc25eb75c.jpg,57,130,7410,5444,1966
train/images717_png_jpg.rf.247c8da4b417997b7adf036cc25eb75c.jpg,72,118,8496,5610,2886
train/images717_png_jpg.rf.4c13897cb59822f622330acea53a1946.jpg,93,121,11253,8289,2964
train/images717_png_jpg.rf.4c13897cb59822f622330acea53a1946.jpg,83,139,11537,8251,3286
train/images717_png_jpg.rf.d1b801165544fb69fb9c9062e02deb45.jpg,76,121,9196,6275,2921
train/images717_png_jpg.rf.d1b801165544fb69fb9c9062e02deb45.jpg,65,129,8385,6249,2136
train/images719_png_jpg.rf.2684961d8bd00c3836c384a89054baa9.jpg,45,124,5580,3837,1743
train/images719_png_jpg.rf.2684961d8bd00c3836c384a89054baa9.jpg,60,100,6000,4135,1865
train/images719_png_jpg.rf.3df6e6ca9d81b0ac010b45262f1621a5.jpg,72,119,8568,5548,3020
train/images719_png_jpg.rf.3df6e6ca9d81b0ac010b45262f1621a5.jpg,58,136,7888,5809,2079
train/images719_png_jpg.rf.fff2b1ee15bb0f0618a7d08f779ebf19.jpg,46,115,5290,2689,2601
train/images719_png_jpg.rf.fff2b1ee15bb0f0618a7d08f779ebf19.jpg,33,99,3267,1886,1381
train/images720_png_jpg.rf.451acacf731cff8aef9dae8155a80884.jpg,63,134,8442,5501,2941
train/images720_png_jpg.rf.451acacf731cff8aef9dae8155a80884.jpg,73,122,8906,5939,2967
train/images720_png_jpg.rf.4d117fd559f50e5a63158412848f52b9.jpg,22,83,1826,1302,524
train/images720_png_jpg.rf.4d117fd559f50e5a63158412848f52b9.jpg,37,107,3959,2350,1609
train/images720_png_jpg.rf.6f17f8750471b547adbb533397436bbd.jpg,61,137,8357,5513,2844
train/images720_png_jpg.rf.6f17f8750471b547adbb533397436bbd.jpg,73,122,8906,6108,2798
train/images721_png_jpg.rf.7a9c68b257d8a9c61e182c749a4e673c.jpg,23,78,1794,1245,549
train/images721_png_jpg.rf.7a9c68b257d8a9c61e182c749a4e673c.jpg,35,106,3710,2152,1558
train/images721_png_jpg.rf.8007a155748cb1f588afd426584618e6.jpg,45,115,5175,3360,1815
train/images721_png_jpg.rf.8007a155748cb1f588afd426584618e6.jpg,31,104,3224,2214,1010
train/images722_png_jpg.rf.363fecd6da689e1d6a73b30b5ebf03fc.jpg,48,126,6048,4070,1978
train/images722_png_jpg.rf.363fecd6da689e1d6a73b30b5ebf03fc.jpg,61,109,6649,4573,2076
train/images722_png_jpg.rf.7f4cdc6d04e227145f7c82653fe16d4b.jpg,44,119,5236,3613,1623
train/images722_png_jpg.rf.7f4cdc6d04e227145f7c82653fe16d4b.jpg,58,104,6032,4146,1886
train/images722_png_jpg.rf.ca0627c5f5e84c3da8789948c4c8c9f7.jpg,23,60,1380,863,517
train/images723_png_jpg.rf.748132fefb9c4b03b5b2920cd24d5abd.jpg,44,122,5368,3710,1658
train/images723_png_jpg.rf.748132fefb9c4b03b5b2920cd24d5abd.jpg,59,109,6431,4373,2058
train/images724_png_jpg.rf.997dc74c00cd0c61768fb1fd86619f67.jpg,52,132,6864,5025,1839
train/images724_png_jpg.rf.997dc74c00cd0c61768fb1fd86619f67.jpg,74,123,9102,6096,3006
train/images724_png_jpg.rf.e33b87aa2e8aa7fe3275cb3027612136.jpg,38,106,4028,2001,2027
train/images724_png_jpg.rf.e33b87aa2e8aa7fe3275cb3027612136.jpg,20,79,1580,980,600
train/images677_png_jpg.rf.f9ebfcc03ceaa3754d339850cee0ee72.jpg,47,158,7426,6054,1372
train/images677_png_jpg.rf.f9ebfcc03ceaa3754d339850cee0ee72.jpg,59,150,8850,6212,2638
train/images682_png_jpg.rf.c9070ae967579e72ddda38a5ca9bdcdc.jpg,66,161,10626,7403,3223
train/images687_png_jpg.rf.226ebf5bad9c1460b86992055a6b521e.jpg,65,184,11960,8678,3282
train/images6_png_jpg.rf.471f04e8e19b7857ca653a08c3094b4d.jpg,36,99,3564,2879,685
train/images704_png_jpg.rf.05e03863048f1ab39a2b5e777fc9cd90.jpg,57,98,5586,4002,1584
train/images704_png_jpg.rf.05e03863048f1ab39a2b5e777fc9cd90.jpg,64,86,5504,3922,1582
train/images709_png_jpg.rf.c9a0b7188d063d6d66b81f071a237a5c.jpg,62,109,6758,4879,1879
train/images709_png_jpg.rf.c9a0b7188d063d6d66b81f071a237a5c.jpg,77,94,7238,4977,2261
train/images714_png_jpg.rf.2795c856e9f141db3f017cb5d1f0ab0b.jpg,94,110,10340,7165,3175
train/images714_png_jpg.rf.2795c856e9f141db3f017cb5d1f0ab0b.jpg,80,126,10080,7021,3059
train/images721_png_jpg.rf.f0bcd926806d7adb4d6ce934d9c6f812.jpg,47,112,5264,3233,2031
train/images721_png_jpg.rf.f0bcd926806d7adb4d6ce934d9c6f812.jpg,36,109,3924,2338,1586
train/images727_png_jpg.rf.05c0c53d7f34c16c0bc6666e3a53c2e1.jpg,37,82,3034,1562,1472
train/images750_png_jpg.rf.176da530fb8798ee4e147c18eec05867.jpg,20,61,1220,938,282
train/images752_png_jpg.rf.0321d55f6013e5be3eb08c020751b28c.jpg,25,59,1475,913,562
train/images753_png_jpg.rf.19348d2a62896bea404a63a5c4d43a24.jpg,32,57,1824,1103,721
train/images754_png_jpg.rf.e14e8acc3cafd3102a8cf1c342238308.jpg,31,58,1798,1136,662
train/images755_png_jpg.rf.46506742dc3e0188a7829aefb112f725.jpg,60,68,4080,2438,1642
train/images755_png_jpg.rf.ccd5271c5fdc6ab57d3360a29a2b9ddf.jpg,58,69,4002,2255,1747
train/images756_png_jpg.rf.5caa57a418873e6b59e24e621c7cb26e.jpg,75,78,5850,3584,2266
train/images756_png_jpg.rf.8042e9859e2629e3d3dfd33c60ab4f15.jpg,74,80,5920,3549,2371
train/images756_png_jpg.rf.aaff8994e0ab8cdd07570290b49ea745.jpg,68,76,5168,3158,2010
train/images757_png_jpg.rf.ab11428bce985ce3f3950adbac4d8bdc.jpg,88,86,7568,4566,3002
train/images757_png_jpg.rf.cfb14da153b4b39925847611ab225a62.jpg,83,87,7221,4637,2584
train/images757_png_jpg.rf.fe2d7c47469c5282c136ca5788b191e8.jpg,89,84,7476,4595,2881
train/images758_png_jpg.rf.2be4b18ac745859f8436ee0e02c4461d.jpg,102,84,8568,5031,3537
train/images758_png_jpg.rf.5cf8bfa9e8175d05e9cbbed486c4f228.jpg,68,90,6120,3679,2441
train/images758_png_jpg.rf.ca003a7109187fcd469182f9d1f4b0f0.jpg,74,89,6586,4114,2472
train/images759_png_jpg.rf.d0593d65fd6009448e01d17d6622b829.jpg,60,62,3720,2798,922
train/images759_png_jpg.rf.f20db191b722a5e01fa2c9c331c0ad6c.jpg,56,64,3584,2608,976
train/images75_png_jpg.rf.6dc6c6e6d3bd737e6c777cd6c2905150.jpg,83,138,11454,9235,2219
train/images75_png_jpg.rf.dca0da7837c3125a2ed900810096486b.jpg,61,148,9028,6226,2802
train/images75_png_jpg.rf.f59b14114a8a3ae1c41dfab5d4250445.jpg,94,145,13630,10785,2845
train/images760_png_jpg.rf.7c20e63f3abc4c0b5b17fe11b82dc918.jpg,19,69,1311,892,419
train/images761_png_jpg.rf.c0ce09408207605a166d5ff096aba5d1.jpg,36,56,2016,1406,610
train/images761_png_jpg.rf.c9b8139e8038b2f2858b832cbbbfbe75.jpg,50,65,3250,2149,1101
train/images762_png_jpg.rf.122fadb19475b7c4a5dd027949b98b9b.jpg,34,56,1904,1136,768
train/images766_png_jpg.rf.65a16d0324d103e66fbbb047be9907ba.jpg,144,93,13392,10151,3241
train/images766_png_jpg.rf.b6c60d75d196c0309947487e2df8213b.jpg,154,93,14322,10235,4087
train/images766_png_jpg.rf.dc96a0d744a795d4feabf703ac856ed1.jpg,153,97,14841,10739,4102
train/images767_png_jpg.rf.0e1463ac41a409e9fe1449e416dba5a7.jpg,154,93,14322,9308,5014
train/images767_png_jpg.rf.1b5465664c4c9dfbadb0037ee7e44699.jpg,153,94,14382,10691,3691
train/images767_png_jpg.rf.41b38e64f83e3045d39082013aaf5b7d.jpg,150,96,14400,9642,4758
train/images768_png_jpg.rf.4bf8916337d5f5da3f97f66d1c83b686.jpg,140,90,12600,8477,4123
train/images768_png_jpg.rf.5b7f23c5595510ea39d9cb721277708e.jpg,140,89,12460,8657,3803
train/images768_png_jpg.rf.88e2acaeacf66824cf51c1bdb8826f60.jpg,145,90,13050,9757,3293
train/images769_png_jpg.rf.56ef42015820feadd5ee266fed39745f.jpg,137,89,12193,8255,3938
train/images769_png_jpg.rf.7d89925ad876ab6b04e490c9ed47f050.jpg,134,92,12328,9446,2882
train/images76_png_jpg.rf.36e548c4493f387da4d6b3fcc38e6028.jpg,49,53,2597,2080,517
train/images76_png_jpg.rf.4bc1bf46119817dba3c0c31300ae4011.jpg,60,51,3060,2454,606
train/images76_png_jpg.rf.bcfa5fc8f7f13ee9a96b1f0f2728ee1e.jpg,92,54,4968,4218,750
train/images770_png_jpg.rf.6d498b45bf16521225690962152b52c4.jpg,137,86,11782,8579,3203
train/images770_png_jpg.rf.9ef837a0a51f21742d61b2932d344fab.jpg,103,91,9373,5946,3427
train/images770_png_jpg.rf.e8ba621478bcfcbbd20b8798a43a7895.jpg,133,87,11571,7989,3582
train/images755_png_jpg.rf.8d4b4d021c3367d9178da64aa3bf6aae.jpg,60,68,4080,2442,1638
train/images759_png_jpg.rf.0d7c5b14df56fbe73f15c28cf9215a50.jpg,77,98,7546,4407,3139
train/images761_png_jpg.rf.f9d634d8e0c8b5339c1b7d7675ef679d.jpg,26,50,1300,857,443
train/images769_png_jpg.rf.2e0510e3973f4601780f0fb38d30f018.jpg,130,94,12220,8732,3488
train/images772_png_jpg.rf.65d5fa8c437e61e30797abee98e22c86.jpg,129,92,11868,8307,3561
train/images772_png_jpg.rf.a6819bce5af7aee273e789d198aacb56.jpg,132,92,12144,8222,3922
train/images772_png_jpg.rf.ac72b3e2dfffe62408139b604a7ff118.jpg,121,88,10648,6826,3822
train/images773_png_jpg.rf.2187b061556aea1c60787f467dc6a444.jpg,149,86,12814,8649,4165
train/images773_png_jpg.rf.3b4dd1075966fdddc553e932e80366d0.jpg,140,91,12740,8615,4125
train/images773_png_jpg.rf.62f7c51c0b4070e18d981b8e24160a5d.jpg,100,84,8400,5569,2831
train/images77_png_jpg.rf.4aecaf5b94a5fbcb85e10b112bb04182.jpg,80,166,13280,9949,3331
train/images77_png_jpg.rf.d6b674b5775d74b3f1c761328c0254a5.jpg,60,163,9780,6652,3128
train/images77_png_jpg.rf.de2739783ebf6ec24d730fa83970f4b8.jpg,74,148,10952,8343,2609
train/images78_png_jpg.rf.4bdc4f22eef748c1e663faa69649820a.jpg,67,161,10787,7522,3265
train/images78_png_jpg.rf.98df301f114561b6074c6bf6c11b0a75.jpg,40,126,5040,3421,1619
train/images78_png_jpg.rf.c3f26623772fbcf8279529cebdac339a.jpg,36,115,4140,2611,1529
train/images79_png_jpg.rf.4b49040f328e4e932f2a3e43de8c875b.jpg,55,143,7865,5483,2382
train/images79_png_jpg.rf.51fca45e9915324fab86aede28b5a2c8.jpg,54,144,7776,5353,2423
train/images79_png_jpg.rf.5bdd73d46abdabdf9a561fdd4f55aa0e.jpg,66,162,10692,7479,3213
train/images80_png_jpg.rf.448db3e70c5bcd5b83d4b22e09935cbf.jpg,150,221,33150,25957,7193
train/images80_png_jpg.rf.af8bbc2f0c20eacfd0bdd15bd15c4d2f.jpg,129,209,26961,19545,7416
train/images80_png_jpg.rf.e097e87d9798cd1cc1556bc58189cffc.jpg,161,213,34293,27685,6608
train/images83_png_jpg.rf.01feeda6b9cea7f7f6393b8b64c604cc.jpg,144,236,33984,22490,11494
train/images83_png_jpg.rf.041cddb47598980ec0d83730cf8d91c8.jpg,145,226,32770,22371,10399
train/images83_png_jpg.rf.c2ab98799133ed93211de42aa6a66303.jpg,125,214,26750,17940,8810
train/images84_png_jpg.rf.8f0588d0e71ff9329cdd34fa33ea9341.jpg,110,214,23540,15480,8060
train/images84_png_jpg.rf.c3ac918ddae580e151595a36acb62a42.jpg,73,175,12775,8125,4650
train/images86_png_jpg.rf.048678b9fffe88bba882f323bc606d46.jpg,96,197,18912,11854,7058
train/images86_png_jpg.rf.3fb01acd4f0fb10738da5ccc84dd5a57.jpg,64,164,10496,6648,3848
train/images86_png_jpg.rf.78633f56f6a6ea8bb84a1621cbacc193.jpg,124,213,26412,17171,9241
train/images877_png_jpg.rf.d240ac0f328b4539945fac473065956b.jpg,40,63,2520,2127,393
train/images890_png_jpg.rf.b273f405f57a5c2ebf2af3d3f2b5e6d1.jpg,62,116,7192,5880,1312
train/images890_png_jpg.rf.fc4da4e4955b0a4a1913fdcbbf94e7a6.jpg,66,121,7986,6549,1437
train/images891_png_jpg.rf.681ca522bd623a781cd835ac679fa7d5.jpg,66,120,7920,6571,1349
train/images891_png_jpg.rf.7c853bc9b5436f7ca77af1b5fc47a03a.jpg,72,126,9072,7326,1746
train/images891_png_jpg.rf.f12be7b908032732f9521bca9c593bf0.jpg,67,124,8308,6630,1678
train/images892_png_jpg.rf.351162c871de18cd24bd3ef2934bc0ce.jpg,71,131,9301,7680,1621
train/images892_png_jpg.rf.77c960cdeaad2ef0e82e36a316b0d3ba.jpg,72,132,9504,7924,1580
train/images892_png_jpg.rf.f767774163ed579f80c504519495cd3a.jpg,71,128,9088,7497,1591
train/images893_png_jpg.rf.34f3bed75348b2a8d4da02254f63db9f.jpg,75,131,9825,7954,1871
train/images893_png_jpg.rf.519401e40ea218913dd1feb142cba35b.jpg,77,128,9856,7988,1868
train/images894_png_jpg.rf.43ffbcfee1c97ba86a84b11bf9155f32.jpg,77,133,10241,8401,1840
train/images894_png_jpg.rf.8ca89d904ab034709016283215095d46.jpg,65,135,8775,7437,1338
train/images894_png_jpg.rf.f723d89b6ff50b05bd46c58511f2325e.jpg,77,139,10703,9009,1694
train/images911_png_jpg.rf.983108afe4d14a8cc6bf6a02bb50992c.jpg,30,91,2730,2134,596
train/images912_png_jpg.rf.9029ca3a0a30edd0c9119be98a92f02b.jpg,31,94,2914,2166,748
train/images913_png_jpg.rf.16b319405fce7f3eb85b045037c41c4d.jpg,39,106,4134,3031,1103
train/images914_png_jpg.rf.9d77893d4d13755891c27d6133376407.jpg,30,101,3030,2314,716
train/images915_png_jpg.rf.052d9aaaa22360160804886d34ba1a27.jpg,46,103,4738,3232,1506
train/images915_png_jpg.rf.2905db13ab8d6fb59a636d8604eb4b9c.jpg,43,106,4558,3224,1334
train/images916_png_jpg.rf.51b8bc0869785ebc89096a1562952551.jpg,46,108,4968,3545,1423
train/images916_png_jpg.rf.5a36fbbb6b9574b4a4cb665c74290e43.jpg,48,109,5232,3592,1640
train/images916_png_jpg.rf.79ed82773355c646c75795230a9be5b4.jpg,47,107,5029,3532,1497
train/images917_png_jpg.rf.d963793949df68d201d5b3454b8245a3.jpg,61,131,7991,5585,2406
train/images917_png_jpg.rf.de5f3dcb022d59336afcb8721b334bfc.jpg,50,130,6500,4580,1920
train/images918_png_jpg.rf.503f5b820c32eb88084c29dff1c52e07.jpg,70,137,9590,6691,2899
train/images918_png_jpg.rf.c71d76199e57558314acbbb921a15327.jpg,66,134,8844,5972,2872
train/images918_png_jpg.rf.dc592828bf66e5531357500b6e757d65.jpg,71,143,10153,6486,3667
train/images919_png_jpg.rf.1491438d517915f04d1cf2f297d1d27d.jpg,79,149,11771,7913,3858
train/images919_png_jpg.rf.54164011e8a1733eebb0e27658c722b0.jpg,78,163,12714,10088,2626
train/images919_png_jpg.rf.682f4cc0c4fff0556e40f3ba4e34d4bd.jpg,81,148,11988,9478,2510
train/images920_png_jpg.rf.1f74a1ff9eda7c4b8ec52e65ac42656c.jpg,75,72,5400,4885,515
train/images921_png_jpg.rf.692532e403b0dd0c0269b2db3e8ba9fc.jpg,99,176,17424,11635,5789
train/images921_png_jpg.rf.7e528be5bc9b245a5d222a9837ac0942.jpg,88,180,15840,11939,3901
train/images921_png_jpg.rf.d38e0faf9bd94b5a920a08e54f339f37.jpg,96,186,17856,11277,6579
train/images922_png_jpg.rf.4f752dcc84116fa60b386c485f5f6dbb.jpg,102,197,20094,15771,4323
train/images922_png_jpg.rf.8bba03a5566568c0b0b2f8327afcd2de.jpg,87,204,17748,13204,4544
train/images922_png_jpg.rf.c9d00d1af4897529cc08c0179856000f.jpg,62,198,12276,7731,4545
train/images923_png_jpg.rf.17df4556c0eb1fdd03bf6ac5f7658b56.jpg,44,137,6028,4024,2004
train/images923_png_jpg.rf.8eaac901f3424c54c5d7721134029f62.jpg,71,192,13632,9216,4416
train/images923_png_jpg.rf.fad121bd07cf848b7f27ae48ce245e53.jpg,26,95,2470,1839,631
train/images924_png_jpg.rf.5b0f7d41a87d3581c64b023fb9d004a4.jpg,45,151,6795,4240,2555
train/images925_png_jpg.rf.7257d7e3ea18a749cea7fdd105bc7cc5.jpg,36,135,4860,3307,1553
train/images84_png_jpg.rf.a666913482701bc10362bf7c9501a641.jpg,145,232,33640,23502,10138
train/images890_png_jpg.rf.7eb71035f83d20d63e9e03ba85d55b72.jpg,65,118,7670,6034,1636
train/images893_png_jpg.rf.e688e72b7ffb36d7be92298eebc5e0be.jpg,77,129,9933,7885,2048
train/images917_png_jpg.rf.cd4c373502739901efc9273d7eb5e457.jpg,59,127,7493,4961,2532
train/images920_png_jpg.rf.e48ef1185adc5a071fc364afb996fb2c.jpg,81,72,5832,5044,788
train/images930_png_jpg.rf.605a7fdb1b49b3d8c22cc188fee6c419.jpg,40,122,4880,3643,1237
train/images930_png_jpg.rf.63faed8e140f3ccd066fe630530e98b4.jpg,43,121,5203,3783,1420
train/images930_png_jpg.rf.ae687c972ade191318c28c52563b5855.jpg,40,127,5080,4055,1025
train/images932_png_jpg.rf.1ba371047b5e5e2b9c3792ebca873df6.jpg,42,128,5376,4137,1239
train/images932_png_jpg.rf.44c65136ddbfcd7c8eebd80814e870f3.jpg,43,129,5547,4262,1285
train/images932_png_jpg.rf.9ea47b6d52861536435fd903a2e4b790.jpg,46,134,6164,4561,1603
train/images932_png_jpg.rf.9ea47b6d52861536435fd903a2e4b790.jpg,54,105,5670,4338,1332
train/images933_png_jpg.rf.6b2d3c68012ce14cd166fa8dce1c3265.jpg,47,138,6486,4800,1686
train/images933_png_jpg.rf.6b2d3c68012ce14cd166fa8dce1c3265.jpg,41,109,4469,3490,979
train/images933_png_jpg.rf.9259f2dcbb8648f5e54dc6875faeb8fd.jpg,48,132,6336,4585,1751
train/images933_png_jpg.rf.9259f2dcbb8648f5e54dc6875faeb8fd.jpg,26,95,2470,1949,521
train/images933_png_jpg.rf.fd9d145630b096b3ff7895373700e65f.jpg,45,128,5760,4341,1419
train/images933_png_jpg.rf.fd9d145630b096b3ff7895373700e65f.jpg,50,103,5150,4207,943
train/images934_png_jpg.rf.189b591a8f424291d5845aaa3efbeadb.jpg,49,136,6664,4906,1758
train/images934_png_jpg.rf.189b591a8f424291d5845aaa3efbeadb.jpg,21,94,1974,1477,497
train/images934_png_jpg.rf.543a75a4eb491db85ddcb3db5c363403.jpg,49,138,6762,5033,1729
train/images934_png_jpg.rf.c1b69862d5777811fe06f543c4cc57ad.jpg,51,141,7191,5192,1999
train/images935_png_jpg.rf.5ccad8e90f74653c5238dc5ca792e7d7.jpg,53,145,7685,5696,1989
train/images935_png_jpg.rf.5ccad8e90f74653c5238dc5ca792e7d7.jpg,38,115,4370,3426,944
train/images935_png_jpg.rf.c8afe2bf5bce5f824c370ee6b8a4c227.jpg,52,149,7748,5877,1871
train/images936_png_jpg.rf.64474b7907d070e652f72745456ba323.jpg,58,152,8816,6338,2478
train/images936_png_jpg.rf.678155c541c61453b774f47db7789d2f.jpg,53,144,7632,5760,1872
train/images936_png_jpg.rf.b8a2be3a7ac0aa3bdc881b6926d9a477.jpg,59,147,8673,6168,2505
train/images937_png_jpg.rf.01900cd1cc26ff3be852d452ea5ac2fe.jpg,24,79,1896,1134,762
train/images937_png_jpg.rf.7bbbcaa4b1b9cc7a9d3653c6f52d8dc0.jpg,20,66,1320,868,452
train/images937_png_jpg.rf.e4baff35891b6001a97b78b907e5266d.jpg,32,132,4224,2332,1892
train/images938_png_jpg.rf.44d09df0becc9b00711d9bebfa706a5b.jpg,32,114,3648,2056,1592
train/images938_png_jpg.rf.c7e2e049469ec8a3ab4f63aeeed42666.jpg,55,175,9625,6958,2667
train/images938_png_jpg.rf.d3d0ed158de34d336bd4e1067a62ce22.jpg,49,162,7938,5547,2391
train/images939_png_jpg.rf.639b64886df54fc1e50a71c03c94a59e.jpg,36,146,5256,3088,2168
train/images939_png_jpg.rf.c5b32dfbf15dda8870da930f675c0604.jpg,52,176,9152,5922,3230
train/images940_png_jpg.rf.4f84145ce1d9988dbc8c48e36675200b.jpg,36,148,5328,3024,2304
train/images940_png_jpg.rf.db6189861dda3a2b1fc78e6737434b3f.jpg,17,52,884,580,304
train/images941_png_jpg.rf.57e8b253fd817e31d6c6f817f595e62e.jpg,101,85,8585,7240,1345
train/images941_png_jpg.rf.6423239c9ebc98ac3402c4d14a067806.jpg,126,82,10332,8418,1914
train/images941_png_jpg.rf.b012d7110ebb90c973b7cbc8546f55ad.jpg,120,80,9600,7894,1706
train/images952_png_jpg.rf.00d6b4b8ccf7220cbb3a5e334ff85cec.jpg,108,83,8964,7479,1485
train/images952_png_jpg.rf.012c89e795e269461602d98ab8e3acb2.jpg,117,88,10296,8598,1698
train/images962_png_jpg.rf.cb6040c517bd0920d8b8a18d606ad5d8.jpg,140,95,13300,10962,2338
train/images962_png_jpg.rf.d11f700a9b7c2183cff116bc1019f72c.jpg,134,89,11926,9798,2128
train/images931_png_jpg.rf.b88fac27654c440e17175e9ae2ce0a97.jpg,124,81,10044,7943,2101
train/images935_png_jpg.rf.61743e0e348f544a04531474c61979cc.jpg,49,139,6811,5059,1752
train/images935_png_jpg.rf.61743e0e348f544a04531474c61979cc.jpg,24,95,2280,1748,532
train/images939_png_jpg.rf.2073ec2b932dc8c5bf6fff35279d4a86.jpg,19,72,1368,754,614
train/images975_png_jpg.rf.bad123b6db1def7967be7d976e8dd024.jpg,25,94,2350,1567,783
train/images979_png_jpg.rf.a707ee504938378736d01c8212783fcd.jpg,65,117,7605,4364,3241
train/images983_png_jpg.rf.5cd899acb660039cf4a42e223bd40c86.jpg,136,96,13056,10714,2342
train/images986_png_jpg.rf.d34cbfdf36363e1fbea900d4febd8ab3.jpg,87,139,12093,7146,4947
train/images990_png_jpg.rf.561a2a47272de1e0dc98db6cff829afc.jpg,95,178,16910,10523,6387
train/images994_png_jpg.rf.4081133c9e773b2434dcf8480b217e56.jpg,164,103,16892,14027,2865
train/images972_png_jpg.rf.e1e45c42453b51524ae7f99fd1b0318b.jpg,43,93,3999,2440,1559
train/images973_png_jpg.rf.0592f3e24e38db2777bea7fdf22f8218.jpg,146,94,13724,11024,2700
train/images973_png_jpg.rf.a371773f7c2bf9ab704f57d680767244.jpg,152,92,13984,11245,2739
train/images973_png_jpg.rf.cc828dda7b905cf14eb1ec9fd1132013.jpg,153,92,14076,11119,2957
train/images974_png_jpg.rf.2a038862c66b42feda3610e100b2a9bf.jpg,41,95,3895,2493,1402
train/images974_png_jpg.rf.982f140fad2a95d5aa95ed637ea0e7dc.jpg,42,104,4368,2868,1500
train/images975_png_jpg.rf.686f8d16af937236dc4cdde28d820240.jpg,27,109,2943,1684,1259
train/images977_png_jpg.rf.0a7c52070c5a9f28fd55213affd91196.jpg,37,112,4144,2710,1434
train/images977_png_jpg.rf.bd6eaa08b45728e9f12161bb390b857d.jpg,61,110,6710,3860,2850
train/images977_png_jpg.rf.e60f1047ef82f252e895d760d65a1d91.jpg,60,112,6720,3970,2750
train/images978_png_jpg.rf.bf6429bec93759e81c292ffc6436b340.jpg,40,119,4760,3227,1533
train/images978_png_jpg.rf.e62866d9386d1be5883d982950e8e3c6.jpg,62,115,7130,4165,2965
train/images978_png_jpg.rf.fe678ad15921fcf743b146b29596709a.jpg,57,115,6555,4025,2530
train/images979_png_jpg.rf.4aefdc42c1b273e69fcbd2bdb62af4f0.jpg,56,116,6496,4159,2337
train/images979_png_jpg.rf.fd4ffc8fc6d5789a8dba222d9471dca6.jpg,67,125,8375,4893,3482
train/images980_png_jpg.rf.6c98a8519c82f0e768b7436ea0f8b93e.jpg,69,123,8487,4876,3611
train/images980_png_jpg.rf.a90d152bc7014df27ad39d502d47aa4b.jpg,44,124,5456,3795,1661
train/images980_png_jpg.rf.fb2f33ab8f02ae2311af6c8cdec337b4.jpg,66,127,8382,5007,3375
train/images981_png_jpg.rf.59a35ddc806e57f1ab3b44863b3f9ed7.jpg,69,124,8556,5027,3529
train/images981_png_jpg.rf.5b0d21dbc18a472f839be294304c5316.jpg,63,126,7938,5036,2902
train/images981_png_jpg.rf.bf56d2972fe671ec12323c23d4e8effc.jpg,68,126,8568,5196,3372
train/images982_png_jpg.rf.3040215e008b5199d504c1912fe85d01.jpg,53,136,7208,5013,2195
train/images982_png_jpg.rf.3ae9fa4df60876883ecaa44f1a4bc329.jpg,79,137,10823,6375,4448
train/images982_png_jpg.rf.e7556d71f6775cd8cd0356597a630760.jpg,74,133,9842,5837,4005
train/images983_png_jpg.rf.f6196525f3c269f58cd695f45d989515.jpg,163,105,17115,13382,3733
train/images984_png_jpg.rf.823e73fb4fb26085c199ab94b3d8af9d.jpg,73,142,10366,6579,3787
train/images984_png_jpg.rf.8b2be6e51d38bd58b493880811e4677a.jpg,84,142,11928,6932,4996
train/images984_png_jpg.rf.b88c56cb758d220d8d873b0aa2cf9929.jpg,80,136,10880,6459,4421
train/images985_png_jpg.rf.83e6e4b4dfa9b3beedf00ad8ab5575a0.jpg,80,137,10960,6497,4463
train/images985_png_jpg.rf.8ea01beb3a21459e1d5e4da863da595c.jpg,82,143,11726,7246,4480
train/images985_png_jpg.rf.c4c125476ca614c5650807f636fbf953.jpg,87,143,12441,7376,5065
train/images986_png_jpg.rf.5d15873a8325e971a1ee6c57ce9d1758.jpg,92,148,13616,7831,5785
train/images986_png_jpg.rf.9412ff69da0c4b5e6054f9b528ea59c6.jpg,88,147,12936,7696,5240
train/images987_png_jpg.rf.061c046166282d7986afbdf34c5172cd.jpg,73,157,11461,7211,4250
train/images987_png_jpg.rf.19dc3a5538896748b67a577fa132a3cc.jpg,100,159,15900,8877,7023
train/images987_png_jpg.rf.df0659ce3687a3a2043e709100586ddd.jpg,102,161,16422,8928,7494
train/images988_png_jpg.rf.4d151165996fef67675f9299d4397f2d.jpg,78,153,11934,7594,4340
train/images988_png_jpg.rf.8324ae05ca2877beca731c6e96e3848f.jpg,74,153,11322,7158,4164
train/images988_png_jpg.rf.9f63fa2bfafaa935d7074d132025eb4f.jpg,69,151,10419,6286,4133
train/images989_png_jpg.rf.18b33f2895514967d5821d603e03d4e3.jpg,48,113,5424,3113,2311
train/images989_png_jpg.rf.8be5fb995122f242e09b5637a60b018c.jpg,74,165,12210,7305,4905
train/images989_png_jpg.rf.f6f834c16799d8084ef1bc1c95223625.jpg,96,165,15840,9662,6178
train/images990_png_jpg.rf.2e505cfbba04b54a123ac44ff0639ce9.jpg,88,170,14960,9448,5512
train/images990_png_jpg.rf.88f0753449a916aed9b086fd686837c3.jpg,75,164,12300,7261,5039
train/images991_png_jpg.rf.33d89a8d8b1f8d9f7cadf07ded627dba.jpg,43,101,4343,2601,1742
train/images991_png_jpg.rf.88d586cdf42700efc8359c7bc0e7b59f.jpg,84,175,14700,8845,5855
train/images991_png_jpg.rf.fc2252c7e6cbbac99fbc3d851fe912e3.jpg,83,176,14608,8792,5816
train/images992_png_jpg.rf.23b82fc33de0e34a635a4e1da5d52b6c.jpg,87,181,15747,9350,6397
train/images992_png_jpg.rf.86ff56c10d5e32ae9826dbda2b1b9b6f.jpg,74,162,11988,7002,4986
train/images992_png_jpg.rf.981f212cd4b2f1bc4d0aca44f2c2c77b.jpg,63,149,9387,5259,4128
train/images993_png_jpg.rf.4d4f904bdc3bbd4d3d99f4b148633679.jpg,62,132,8184,4855,3329
train/images993_png_jpg.rf.6b217b271c1f31bd4ed5adac9b977270.jpg,40,92,3680,2378,1302
train/images993_png_jpg.rf.e5d2b92ada22ffac1178b4eb6a3eea36.jpg,29,73,2117,1422,695
train/images994_png_jpg.rf.c3fc4b14c7ac52c8918c38479bf157f6.jpg,150,100,15000,12049,2951
train/images994_png_jpg.rf.ddf4d6486d8152606371031dca25485e.jpg,143,99,14157,11680,2477
valid/images1008_png_jpg.rf.9359b3e515f5825bdec9fa7d18f03fe8.jpg,16,19,304,215,89
valid/images1017_png_jpg.rf.96340f540f90606ff0b6542138481801.jpg,19,40,760,546,214
valid/images1021_png_jpg.rf.3b199a2aa431af1109beafb66f54e85a.jpg,33,47,1551,1102,449
valid/images102_png_jpg.rf.6d9caccaa5f1e8d08df7337a42c5756f.jpg,25,77,1925,1170,755
valid/images102_png_jpg.rf.6d9caccaa5f1e8d08df7337a42c5756f.jpg,39,65,2535,1361,1174
valid/images1060_png_jpg.rf.644a07d275bea6bc21bed97aaa6a36a1.jpg,50,55,2750,1907,843
valid/images118_png_jpg.rf.e97c33320a8c2374aece09322331d343.jpg,72,135,9720,7406,2314
valid/images1364_png_jpg.rf.6cccb225767d0b52acef0f1dd1797f76.jpg,70,168,11760,6759,5001
valid/images1364_png_jpg.rf.6cccb225767d0b52acef0f1dd1797f76.jpg,31,109,3379,2489,890
valid/images136_png_jpg.rf.a9ba34644e2969b94648c9f68a258c57.jpg,65,141,9165,7154,2011
valid/images136_png_jpg.rf.a9ba34644e2969b94648c9f68a258c57.jpg,37,80,2960,2256,704
valid/images147_png_jpg.rf.0da91e9f12319048653fa51f3a7e131f.jpg,42,127,5334,4152,1182
valid/images162_png_jpg.rf.081e6f8572bd73df983873aad9ead6ef.jpg,38,89,3382,2643,739
valid/images165_png_jpg.rf.9bbf55309a27f8cf4a5887d32695bc23.jpg,47,99,4653,3486,1167
valid/images167_png_jpg.rf.9cd5e3230851bc29fee71d78f89ce0ad.jpg,48,108,5184,4164,1020
valid/images18_png_jpg.rf.66f5a724061424f3ba3cba42e146ee56.jpg,91,120,10920,7706,3214
valid/images222_png_jpg.rf.4850061aa88015e82999e7680637e9e6.jpg,34,55,1870,1273,597
valid/images222_png_jpg.rf.4850061aa88015e82999e7680637e9e6.jpg,59,165,9735,6543,3192
valid/images222_png_jpg.rf.4850061aa88015e82999e7680637e9e6.jpg,69,129,8901,5927,2974
valid/images225_png_jpg.rf.2e8e4295d2752d25d37cb12932b820b4.jpg,42,63,2646,1715,931
valid/images226_png_jpg.rf.3fdc57a4b92f6c6591cdb91e8cf885ba.jpg,45,67,3015,1975,1040
valid/images228_png_jpg.rf.8e75058f0be84dc850591a70b18d3fbd.jpg,51,77,3927,2658,1269
valid/images251_png_jpg.rf.9188cacfec3e067820796948b6b0eb23.jpg,55,109,5995,4400,1595
valid/images104_png_jpg.rf.0ce7dd6817fdcc5a113fd91fd80dae5d.jpg,54,71,3834,2137,1697
valid/images158_png_jpg.rf.412aab0eca94abcf1a39bc3d39f9fbe6.jpg,28,75,2100,1634,466
valid/images252_png_jpg.rf.582dfbb1540b21608f901e31c2cde441.jpg,52,121,6292,4819,1473
valid/images5_png_jpg.rf.d24e9ab23dbb441e22b01f84d0287d8c.jpg,42,85,3570,2617,953
valid/images649_png_jpg.rf.dc1070b96432e718c3378eb6577b3e27.jpg,70,119,8330,6306,2024
valid/images284_png_jpg.rf.5ca6ef460ac09c004fa94a2fe383eeb1.jpg,99,134,13266,8847,4419
valid/images284_png_jpg.rf.5ca6ef460ac09c004fa94a2fe383eeb1.jpg,37,46,1702,779,923
valid/images35_png_jpg.rf.f524dc308f2c114c9c979ffdfbf67861.jpg,110,74,8140,5347,2793
valid/images400_png_jpg.rf.13f7a442a075d0ed88e8ee37dadbac29.jpg,59,150,8850,7642,1208
valid/images402_png_jpg.rf.1b9e2288d6eca88d3fa65ed4d9f9b938.jpg,48,168,8064,7016,1048
valid/images441_png_jpg.rf.739f6a2cad572b03f94b361fc0bde7f2.jpg,73,186,13578,10032,3546
valid/images44_png_jpg.rf.1f970351cd64a21d2e96cebc74bab9e5.jpg,68,40,2720,2099,621
valid/images452_png_jpg.rf.22357f12408dabdecb8ca81d3eaf512b.jpg,14,71,994,764,230
valid/images452_png_jpg.rf.22357f12408dabdecb8ca81d3eaf512b.jpg,11,54,594,519,75
valid/images457_png_jpg.rf.ed87a90dfa576f4a1e45cffa35c08185.jpg,32,78,2496,1761,735
valid/images457_png_jpg.rf.ed87a90dfa576f4a1e45cffa35c08185.jpg,28,64,1792,1457,335
valid/images460_png_jpg.rf.fe37b010d72591ebbe3b1793fc4bb65d.jpg,37,66,2442,1916,526
valid/images460_png_jpg.rf.fe37b010d72591ebbe3b1793fc4bb65d.jpg,39,80,3120,2130,990
valid/images462_png_jpg.rf.10c4b6cf17869d7fddd171cfbc163ac4.jpg,42,69,2898,2225,673
valid/images462_png_jpg.rf.10c4b6cf17869d7fddd171cfbc163ac4.jpg,42,82,3444,2409,1035
valid/images489_png_jpg.rf.924523b76723c675654955f27159d70c.jpg,51,97,4947,2868,2079
valid/images489_png_jpg.rf.924523b76723c675654955f27159d70c.jpg,88,46,4048,2900,1148
valid/images490_png_jpg.rf.62c267bc8b7512610df40328d1c6dd30.jpg,53,100,5300,3129,2171
valid/images490_png_jpg.rf.62c267bc8b7512610df40328d1c6dd30.jpg,75,43,3225,2035,1190
valid/images499_png_jpg.rf.5c5814d921cf7dd9f9e76732e03052db.jpg,74,127,9398,5556,3842
valid/images503_png_jpg.rf.3ac8712cf97a4e7c3af38d5f855b6b64.jpg,28,41,1148,848,300
valid/images504_png_jpg.rf.a8ace1188c7d27e69523f020b8239c0a.jpg,27,47,1269,973,296
valid/images509_png_jpg.rf.49a6789c7a77460499556648c8fd12fd.jpg,38,56,2128,1437,691
valid/images536_png_jpg.rf.d9a1eb8c523c67c53173b03fc884f08b.jpg,123,75,9225,6311,2914
valid/images552_png_jpg.rf.7250812d8d0a1f443f0ee2364a389ba5.jpg,77,144,11088,6868,4220
valid/images559_png_jpg.rf.375f7b9ce278d070cbf4b30ee46682b5.jpg,37,71,2627,2228,399
valid/images561_png_jpg.rf.d762a8a30c7f1d81a317abacfe6b020d.jpg,36,35,1260,1067,193
valid/images561_png_jpg.rf.d762a8a30c7f1d81a317abacfe6b020d.jpg,24,84,2016,1667,349
valid/images600_png_jpg.rf.178599754622f37be192de0707c2b3a3.jpg,36,51,1836,1161,675
valid/images600_png_jpg.rf.178599754622f37be192de0707c2b3a3.jpg,22,76,1672,922,750
valid/images616_png_jpg.rf.db065aca8c491199605abd43d0ec9260.jpg,20,99,1980,1315,665
valid/images617_png_jpg.rf.b3c8ca3e1cdc5e1fdc06f19a8a53cdfe.jpg,20,95,1900,1333,567
valid/images618_png_jpg.rf.a85218cb732ce019ad9209404d1d1222.jpg,21,95,1995,1378,617
valid/images632_png_jpg.rf.a6ce26932068529057f5795c8aa0d869.jpg,41,108,4428,3291,1137
valid/images641_png_jpg.rf.92debfa46164b5701cddc24a2ff517c4.jpg,58,116,6728,5159,1569
valid/images642_png_jpg.rf.897e49028370a2fb387633cba07e632d.jpg,60,115,6900,5323,1577
valid/images645_png_jpg.rf.a0858c09201083523cf08828f3ab7682.jpg,66,120,7920,5826,2094
valid/images651_png_jpg.rf.96b40e1f032a717de072e85db594157a.jpg,72,120,8640,6621,2019
valid/images652_png_jpg.rf.ea2a3f1d9a0ac47962a1c1aae878e18b.jpg,74,121,8954,6873,2081
valid/images653_png_jpg.rf.7d3bdb010ac429d56e5e80d10f5dd2b9.jpg,75,121,9075,6895,2180
valid/images655_png_jpg.rf.155cfc0972ffa77684b5aac802fc2db2.jpg,82,124,10168,7547,2621
valid/images661_png_jpg.rf.4ec596e6c6adb44a0f0c988d59a7e5d9.jpg,85,134,11390,8593,2797
valid/images665_png_jpg.rf.6313cc03b47341ddbbc4e89327059876.jpg,55,128,7040,5394,1646
valid/images665_png_jpg.rf.6313cc03b47341ddbbc4e89327059876.jpg,42,117,4914,3417,1497
valid/images667_png_jpg.rf.e0eaf3563ac048467fc93bfeb961f8be.jpg,59,132,7788,5838,1950
valid/images667_png_jpg.rf.e0eaf3563ac048467fc93bfeb961f8be.jpg,46,127,5842,3971,1871
valid/images681_png_jpg.rf.61e3b105c13ae2793d81b6280176c53b.jpg,60,150,9000,6059,2941
valid/images683_png_jpg.rf.a2e251d40cd36f6a34588b64c4ca3895.jpg,67,153,10251,6835,3416
valid/images689_png_jpg.rf.1adb10c7c36bf0e27132a243ec42fa04.jpg,55,178,9790,7261,2529
valid/images693_png_jpg.rf.3b688175305d0bb03480a1bbc9538cd1.jpg,34,159,5406,3483,1923
valid/images706_png_jpg.rf.cdff3028f910cd50c627a24a7c6eb384.jpg,61,100,6100,4192,1908
valid/images706_png_jpg.rf.cdff3028f910cd50c627a24a7c6eb384.jpg,64,85,5440,3887,1553
test/images1027_png_jpg.rf.c2cdc943219f639502cd7c33821f8245.jpg,46,59,2714,1924,790
test/images1061_png_jpg.rf.37548f85647074cffc1b6ca73f585a0c.jpg,35,61,2135,1426,709
test/images128_png_jpg.rf.0f38a2338b8f0a52fef9bf89622fdf62.jpg,76,158,12008,8513,3495
test/images161_png_jpg.rf.0e985e52682926807e629e2e557c4a5c.jpg,33,83,2739,2220,519
test/images185_png_jpg.rf.7d9368990c10bcfbe64aada663b0100b.jpg,84,93,7812,4635,3177
test/images196_png_jpg.rf.09d2b07cf31b4ae21e387399dc787d5f.jpg,105,102,10710,5606,5104
test/images219_png_jpg.rf.d6548dad3c4487e409c2e7d00dc466c3.jpg,71,142,10082,6167,3915
test/images219_png_jpg.rf.d6548dad3c4487e409c2e7d00dc466c3.jpg,33,58,1914,1171,743
test/images219_png_jpg.rf.d6548dad3c4487e409c2e7d00dc466c3.jpg,76,122,9272,6129,3143
test/images221_png_jpg.rf.e6f910125df69c8f82c7bf1e49eea1c3.jpg,72,157,11304,7638,3666
test/images221_png_jpg.rf.e6f910125df69c8f82c7bf1e49eea1c3.jpg,34,57,1938,1214,724
test/images221_png_jpg.rf.e6f910125df69c8f82c7bf1e49eea1c3.jpg,79,137,10823,6235,4588
test/images248_png_jpg.rf.1a29cf649cda2cf9caa0f772dfb3e451.jpg,43,95,4085,3034,1051
test/images392_png_jpg.rf.55555ea61497af7a0536ac52839ee8ea.jpg,18,92,1656,1368,288
test/images395_png_jpg.rf.2d28ecb6d475d82a7c2005496b101d46.jpg,31,106,3286,2798,488
test/images428_png_jpg.rf.fe6168dcf18cad81fef145a2b83d37ee.jpg,65,115,7475,6119,1356
test/images436_png_jpg.rf.669eadea869d25e6b9f1cc2a0110b83c.jpg,65,74,4810,3069,1741
test/images436_png_jpg.rf.669eadea869d25e6b9f1cc2a0110b83c.jpg,58,69,4002,3056,946
test/images440_png_jpg.rf.1c8e413b36b6ac15c703d16b91df9bc2.jpg,71,180,12780,9289,3491
test/images45_png_jpg.rf.276f2990714d6c6be1c8873fdb5ab3eb.jpg,132,124,16368,10704,5664
test/images45_png_jpg.rf.276f2990714d6c6be1c8873fdb5ab3eb.jpg,82,83,6806,4864,1942
test/images45_png_jpg.rf.276f2990714d6c6be1c8873fdb5ab3eb.jpg,53,57,3021,1616,1405
test/images1162_png_jpg.rf.f5304d4b2551bf770fcf9af4ea8b903c.jpg,35,69,2415,1690,725
test/images570_png_jpg.rf.9fa99081e705cf256fab5b01257b125c.jpg,50,111,5550,4565,985
test/images611_png_jpg.rf.f7f65bc93f37fed432eb9455089ae645.jpg,31,42,1302,867,435
test/images611_png_jpg.rf.f7f65bc93f37fed432eb9455089ae645.jpg,18,71,1278,803,475
test/images629_png_jpg.rf.27e1721868e16572cc3fd066cdc39ca4.jpg,35,105,3675,2627,1048
test/images643_png_jpg.rf.ecf48c67f94005082567765d295e8b51.jpg,28,54,1512,1030,482
test/images669_png_jpg.rf.4b0aff334e8092aaab1ba6f4268ea387.jpg,62,137,8494,6338,2156
test/images669_png_jpg.rf.4b0aff334e8092aaab1ba6f4268ea387.jpg,46,126,5796,4002,1794
test/images521_png_jpg.rf.44c05932de86b93a7d6a5917f2cefefb.jpg,30,105,3150,2161,989
test/images537_png_jpg.rf.265d962e619783a65dba5a2fe41f0d88.jpg,74,57,4218,2966,1252
test/images537_png_jpg.rf.265d962e619783a65dba5a2fe41f0d88.jpg,34,73,2482,1759,723
test/images547_png_jpg.rf.8774c9e6d7ed1499b464c675f31a45e0.jpg,53,99,5247,3031,2216
test/images550_png_jpg.rf.0f6e63deff39d89afe46555068838ccc.jpg,118,100,11800,9332,2468
test/images550_png_jpg.rf.0f6e63deff39d89afe46555068838ccc.jpg,14,34,476,352,124
test/images553_png_jpg.rf.ca2b65f774a319c6b4f4d27f47bfb1e3.jpg,41,48,1968,1345,623
test/images55_png_jpg.rf.8d79b9c870aff6036e2dbaa9b7232c9e.jpg,73,42,3066,2507,559
test/images579_png_jpg.rf.f6dbd7251e5d1a9d0ee9f4347a3e06db.jpg,46,63,2898,1596,1302
test/images579_png_jpg.rf.f6dbd7251e5d1a9d0ee9f4347a3e06db.jpg,32,83,2656,1932,724
test/images590_png_jpg.rf.4ae7f65785bcd1fc12bc75d1dcc650d4.jpg,41,55,2255,1438,817
test/images590_png_jpg.rf.4ae7f65785bcd1fc12bc75d1dcc650d4.jpg,27,78,2106,1180,926
test/images615_png_jpg.rf.5faf544ee4e32c7be22bc2f37ceb58e0.jpg,20,90,1800,1172,628
test/images619_png_jpg.rf.e896af78450aa641ba60883a115ff01a.jpg,21,92,1932,1371,561
test/images620_png_jpg.rf.96bb9cf3c79b287f0586d2b093fcbf16.jpg,23,97,2231,1573,658
test/images622_png_jpg.rf.8e0b68ee37f6ab119590af89015f131f.jpg,25,42,1050,672,378
test/images622_png_jpg.rf.8e0b68ee37f6ab119590af89015f131f.jpg,49,64,3136,1725,1411
test/images623_png_jpg.rf.ae042b2a060248f19e0482a653402148.jpg,24,96,2304,1658,646
test/images624_png_jpg.rf.f689fffd7336ea4d967946d0401541ec.jpg,25,101,2525,1790,735
test/images625_png_jpg.rf.3af54a67fa65e56ad7567e8124529dde.jpg,27,100,2700,1883,817
test/images626_png_jpg.rf.c70e39ec10c9ab0d82edf879c5ec0008.jpg,30,104,3120,2157,963
test/images627_png_jpg.rf.66bfd009577a9cb79703382c309915b1.jpg,30,103,3090,2263,827
test/images628_png_jpg.rf.341f5038c5920326fc2904765ab3943b.jpg,31,105,3255,2293,962
test/images630_png_jpg.rf.9d31e8f9c9c9e1ef88dc80e29a8d0116.jpg,37,107,3959,2896,1063
test/images631_png_jpg.rf.f443ab1c38f12cacb7c1a63a7b5f5ce4.jpg,39,109,4251,3102,1149
test/images633_png_jpg.rf.b3acaec9f1247035c615e85320e496c1.jpg,19,37,703,441,262
test/images633_png_jpg.rf.b3acaec9f1247035c615e85320e496c1.jpg,41,59,2419,1468,951
test/images634_png_jpg.rf.17e8e866f599d3c4dada760b4963f85e.jpg,46,110,5060,3736,1324
test/images635_png_jpg.rf.7c803a4f9b6f9e2369dfd917d1c01c3a.jpg,49,109,5341,3932,1409
test/images636_png_jpg.rf.c56cb7c613b032bcbe706053f682f47a.jpg,51,107,5457,3969,1488
test/images637_png_jpg.rf.1843fb2492a5d732defb56b0b7366b1e.jpg,52,115,5980,4457,1523
test/images638_png_jpg.rf.2cf28737e9f769f8867bbb4f623b0a88.jpg,54,116,6264,4662,1602
test/images639_png_jpg.rf.544a2680e79872c9d52acead7faba6af.jpg,56,116,6496,4841,1655
test/images640_png_jpg.rf.ee6061d0b15a1b6d3d09b7aa3ce4914d.jpg,58,117,6786,5159,1627
test/images644_png_jpg.rf.001228643c2883ae38ab0da038141594.jpg,64,119,7616,5490,2126
test/images646_png_jpg.rf.a0440c2fd6bad84473d4f2df5a8a6a5f.jpg,68,118,8024,5927,2097
test/images647_png_jpg.rf.f8f67f00e02430829f22b9d71a4dbb05.jpg,68,121,8228,6207,2021
test/images650_png_jpg.rf.462cd66f800c5caf714bf8f387214c2a.jpg,71,122,8662,6436,2226
test/images654_png_jpg.rf.74feff56e0dce79a90a4427aa44cd8f7.jpg,80,122,9760,7289,2471
test/images657_png_jpg.rf.ba40ea3991ea2d35766433f6649062ff.jpg,79,125,9875,7403,2472
test/images659_png_jpg.rf.85cf08de9262e2a4b7c8ee7febbf2223.jpg,90,128,11520,8578,2942
test/images660_png_jpg.rf.8444b99ba645a027c3461825046db2b7.jpg,90,129,11610,8809,2801
test/images662_png_jpg.rf.0968361ff636ab7afddcef70a9371fff.jpg,52,126,6552,4979,1573
test/images662_png_jpg.rf.0968361ff636ab7afddcef70a9371fff.jpg,41,117,4797,3407,1390
test/images668_png_jpg.rf.817006d43d25742eadbf10872e25f5b1.jpg,60,134,8040,6018,2022
test/images668_png_jpg.rf.817006d43d25742eadbf10872e25f5b1.jpg,46,123,5658,3943,1715
test/images672_png_jpg.rf.20f0fbf6857b60fb59530e4adfe5712e.jpg,58,143,8294,6562,1732
test/images672_png_jpg.rf.20f0fbf6857b60fb59530e4adfe5712e.jpg,50,130,6500,4512,1988
test/images673_png_jpg.rf.a8ea7d9d87ff9079f24e13bff75c8dfc.jpg,54,142,7668,6312,1356
test/images673_png_jpg.rf.a8ea7d9d87ff9079f24e13bff75c8dfc.jpg,52,136,7072,4752,2320
test/images675_png_jpg.rf.ec111645d3330346bce2aeda32a9e5d1.jpg,48,145,6960,5619,1341
test/images675_png_jpg.rf.ec111645d3330346bce2aeda32a9e5d1.jpg,52,136,7072,4952,2120
test/images688_png_jpg.rf.9d92e0fafb2cd3d121d8b787dd02f65f.jpg,61,166,10126,7399,2727
test/images690_png_jpg.rf.473b49acfe23e43a730272e985e64fbd.jpg,51,183,9333,6655,2678
test/images692_png_jpg.rf.b57febef802c43a527cb4e8c3924747e.jpg,41,186,7626,4727,2899
test/images701_png_jpg.rf.b026ff98534bde0c617a5279fc0e474d.jpg,51,90,4590,3150,1440
test/images701_png_jpg.rf.b026ff98534bde0c617a5279fc0e474d.jpg,54,75,4050,2998,1052
test/images712_png_jpg.rf.0ff7608710a373228f5a73019309c91f.jpg,63,107,6741,4717,2024
test/images712_png_jpg.rf.0ff7608710a373228f5a73019309c91f.jpg,78,92,7176,4927,2249
