imgpath,height,width,area,pothole_area,nonpothole_area
/media/gufran/GsHDD/Work/Projects/AI/PotholeSeverityClassification/Data/Step1_data/OriginalDataset/600_png.rf.10df765e7f4560535cce7eacaf3d3253.jpg,81,178,14418,12087,2331
/media/gufran/GsHDD/Work/Projects/AI/PotholeSeverityClassification/Data/Step1_data/OriginalDataset/732_png.rf.a91c1b1bb69338518182cea31e730c99.jpg,304,508,154432,111222,43210
/media/gufran/GsHDD/Work/Projects/AI/PotholeSeverityClassification/Data/Step1_data/OriginalDataset/732_png.rf.a91c1b1bb69338518182cea31e730c99.jpg,343,496,170128,107645,62483
/media/gufran/GsHDD/Work/Projects/AI/PotholeSeverityClassification/Data/Step1_data/OriginalDataset/1000_png.rf.f28e7261617f06b8bfe9eef2ba0135e9.jpg,406,811,329266,196209,133057
/media/gufran/GsHDD/Work/Projects/AI/PotholeSeverityClassification/Data/Step1_data/OriginalDataset/1001_png.rf.0d08faf8b39fe458e48ca93ea3767acf.jpg,383,805,308315,197891,110424
/media/gufran/GsHDD/Work/Projects/AI/PotholeSeverityClassification/Data/Step1_data/OriginalDataset/1002_png.rf.3193a978feef0658ec42a8bfa9daf0dc.jpg,346,800,276800,164291,112509
/media/gufran/GsHDD/Work/Projects/AI/PotholeSeverityClassification/Data/Step1_data/OriginalDataset/1003_png.rf.366e5ca30518f45892721019f4c7c729.jpg,296,695,205720,124940,80780
/media/gufran/GsHDD/Work/Projects/AI/PotholeSeverityClassification/Data/Step1_data/OriginalDataset/1005_png.rf.387999f45be31ce5eca6e0a1d4a910f0.jpg,111,295,32745,24211,8534
/media/gufran/GsHDD/Work/Projects/AI/PotholeSeverityClassification/Data/Step1_data/OriginalDataset/1007_png.rf.9b8f6aa3fe5a1777ac9e5efcb5d4e001.jpg,85,181,15385,12147,3238
/media/gufran/GsHDD/Work/Projects/AI/PotholeSeverityClassification/Data/Step1_data/OriginalDataset/1008_png.rf.071a0a4b3d710ec4ce3d2113899ae1c4.jpg,109,202,22018,17237,4781
/media/gufran/GsHDD/Work/Projects/AI/PotholeSeverityClassification/Data/Step1_data/OriginalDataset/1009_png.rf.346cbb0d28fb70948667452de7f86214.jpg,134,232,31088,23849,7239
/media/gufran/GsHDD/Work/Projects/AI/PotholeSeverityClassification/Data/Step1_data/OriginalDataset/1016_png.rf.31c6e4f0cae3f621144de75e6be34d57.jpg,153,319,48807,39111,9696
/media/gufran/GsHDD/Work/Projects/AI/PotholeSeverityClassification/Data/Step1_data/OriginalDataset/101_png.rf.94dff69f49fd6cb4b5ce06fa188cccab.jpg,367,308,113036,81954,31082
/media/gufran/GsHDD/Work/Projects/AI/PotholeSeverityClassification/Data/Step1_data/OriginalDataset/1026_png.rf.cd13496201abb956d546db0039cf61be.jpg,211,335,70685,58196,12489
/media/gufran/GsHDD/Work/Projects/AI/PotholeSeverityClassification/Data/Step1_data/OriginalDataset/1033_png.rf.b0948b36738e35b8e4fb02b5dbe073f0.jpg,123,235,28905,19781,9124
/media/gufran/GsHDD/Work/Projects/AI/PotholeSeverityClassification/Data/Step1_data/OriginalDataset/1034_png.rf.11bf079ed4f2915462d7ccaee43290b8.jpg,154,253,38962,28300,10662
/media/gufran/GsHDD/Work/Projects/AI/PotholeSeverityClassification/Data/Step1_data/OriginalDataset/1035_png.rf.dfbe2e94fedfa28478bbe932e6c43500.jpg,191,274,52334,36559,15775
/media/gufran/GsHDD/Work/Projects/AI/PotholeSeverityClassification/Data/Step1_data/OriginalDataset/1036_png.rf.2f0333b9b82ffd1ad6352272816d7e1a.jpg,217,301,65317,44846,20471
/media/gufran/GsHDD/Work/Projects/AI/PotholeSeverityClassification/Data/Step1_data/OriginalDataset/1037_png.rf.a42558d216fb4dfb4705ece7a77d4b47.jpg,248,326,80848,56854,23994
/media/gufran/GsHDD/Work/Projects/AI/PotholeSeverityClassification/Data/Step1_data/OriginalDataset/1038_png.rf.ff38cbf5b4c35c515c79fb4cc85dbe0e.jpg,283,359,101597,72447,29150
/media/gufran/GsHDD/Work/Projects/AI/PotholeSeverityClassification/Data/Step1_data/OriginalDataset/1039_png.rf.007fce662cf6fbb332610d34c5f085ed.jpg,265,403,106795,86894,19901
/media/gufran/GsHDD/Work/Projects/AI/PotholeSeverityClassification/Data/Step1_data/OriginalDataset/1040_png.rf.8cc62bc67bd7356ff58d09bd7278fa3b.jpg,169,424,71656,54252,17404
/media/gufran/GsHDD/Work/Projects/AI/PotholeSeverityClassification/Data/Step1_data/OriginalDataset/1047_png.rf.55cd9413c74b40349a657b483cea1fef.jpg,360,404,145440,119657,25783
/media/gufran/GsHDD/Work/Projects/AI/PotholeSeverityClassification/Data/Step1_data/OriginalDataset/1062_png.rf.7bd86ee7f06f294454e4f906e092ee1e.jpg,105,169,17745,13103,4642
/media/gufran/GsHDD/Work/Projects/AI/PotholeSeverityClassification/Data/Step1_data/OriginalDataset/1063_png.rf.549fce582083306a66d5f3294d4870ee.jpg,151,187,28237,19994,8243
/media/gufran/GsHDD/Work/Projects/AI/PotholeSeverityClassification/Data/Step1_data/OriginalDataset/1064_png.rf.71c5c2b535da3c0e6d0ee1792ed7fea0.jpg,175,190,33250,23937,9313
/media/gufran/GsHDD/Work/Projects/AI/PotholeSeverityClassification/Data/Step1_data/OriginalDataset/1065_png.rf.4e6ac8684d252e78173228d96c54613c.jpg,202,208,42016,30240,11776
/media/gufran/GsHDD/Work/Projects/AI/PotholeSeverityClassification/Data/Step1_data/OriginalDataset/1010_png.rf.f675ad20859befa6c60a5aba9ea816e9.jpg,173,277,47921,36991,10930
/media/gufran/GsHDD/Work/Projects/AI/PotholeSeverityClassification/Data/Step1_data/OriginalDataset/1091_png.rf.494fcedad646dfde178550c2dbfe5637.jpg,370,697,257890,141614,116276
/media/gufran/GsHDD/Work/Projects/AI/PotholeSeverityClassification/Data/Step1_data/OriginalDataset/1261_png.rf.21cb8b533109ffd268cfb5efe31f65f3.jpg,65,244,15860,11906,3954
/media/gufran/GsHDD/Work/Projects/AI/PotholeSeverityClassification/Data/Step1_data/OriginalDataset/1082_png.rf.fe6ca3872128e1442bf3e2babf9e56da.jpg,135,493,66555,41711,24844
/media/gufran/GsHDD/Work/Projects/AI/PotholeSeverityClassification/Data/Step1_data/OriginalDataset/1083_png.rf.02da0db6deadd9ea9e53cffd2bfe7351.jpg,162,493,79866,51514,28352
/media/gufran/GsHDD/Work/Projects/AI/PotholeSeverityClassification/Data/Step1_data/OriginalDataset/1084_png.rf.cc1778bd617cdc2e733295dcdc17c27f.jpg,195,538,104910,64558,40352
/media/gufran/GsHDD/Work/Projects/AI/PotholeSeverityClassification/Data/Step1_data/OriginalDataset/1085_png.rf.1b5f29f5dc508ece694da7590065f8ae.jpg,222,547,121434,73892,47542
/media/gufran/GsHDD/Work/Projects/AI/PotholeSeverityClassification/Data/Step1_data/OriginalDataset/1086_png.rf.939b7604e98a21828f16e2f21e2a6af1.jpg,261,583,152163,88200,63963
/media/gufran/GsHDD/Work/Projects/AI/PotholeSeverityClassification/Data/Step1_data/OriginalDataset/1087_png.rf.fe82a872dde81ce445af7243280d5169.jpg,286,592,169312,97450,71862
/media/gufran/GsHDD/Work/Projects/AI/PotholeSeverityClassification/Data/Step1_data/OriginalDataset/1088_png.rf.a5d848761ec2062a0503600a38791826.jpg,316,628,198448,110892,87556
/media/gufran/GsHDD/Work/Projects/AI/PotholeSeverityClassification/Data/Step1_data/OriginalDataset/1089_png.rf.4ea1e503a2cc780642d05f40aeda443f.jpg,115,256,29440,21663,7777
/media/gufran/GsHDD/Work/Projects/AI/PotholeSeverityClassification/Data/Step1_data/OriginalDataset/1090_png.rf.b8a7425760386a070c934037d2a9c664.jpg,346,667,230782,126650,104132
/media/gufran/GsHDD/Work/Projects/AI/PotholeSeverityClassification/Data/Step1_data/OriginalDataset/1092_png.rf.e2e3bbdf7e5a5711d0bd4816617bbd70.jpg,394,730,287620,162463,125157
/media/gufran/GsHDD/Work/Projects/AI/PotholeSeverityClassification/Data/Step1_data/OriginalDataset/1093_png.rf.371739a56f993df3f73a61143f2e32f1.jpg,418,763,318934,182797,136137
/media/gufran/GsHDD/Work/Projects/AI/PotholeSeverityClassification/Data/Step1_data/OriginalDataset/1094_png.rf.dcbadb055f16ffc3979c1b7f2b3ed8f2.jpg,368,773,284464,185496,98968
/media/gufran/GsHDD/Work/Projects/AI/PotholeSeverityClassification/Data/Step1_data/OriginalDataset/1095_png.rf.26e394c4e68fa9a24a286be06e910768.jpg,355,814,288970,183088,105882
/media/gufran/GsHDD/Work/Projects/AI/PotholeSeverityClassification/Data/Step1_data/OriginalDataset/1096_png.rf.9d809837bd1db56aa11f13d05a013e43.jpg,331,794,262814,154554,108260
/media/gufran/GsHDD/Work/Projects/AI/PotholeSeverityClassification/Data/Step1_data/OriginalDataset/1097_png.rf.d959b85fa1e3fb530d3f4ac85a9329a3.jpg,124,259,32116,23878,8238
/media/gufran/GsHDD/Work/Projects/AI/PotholeSeverityClassification/Data/Step1_data/OriginalDataset/1099_png.rf.a68473c40b89655da69ea8834525b67c.jpg,136,265,36040,25285,10755
/media/gufran/GsHDD/Work/Projects/AI/PotholeSeverityClassification/Data/Step1_data/OriginalDataset/1163_png.rf.5b784506b2cdf7e27738d304d09039d1.jpg,151,265,40015,30501,9514
/media/gufran/GsHDD/Work/Projects/AI/PotholeSeverityClassification/Data/Step1_data/OriginalDataset/1165_png.rf.89e5a5ae65381b50c20f6aae2b6a10ce.jpg,274,394,107956,80012,27944
/media/gufran/GsHDD/Work/Projects/AI/PotholeSeverityClassification/Data/Step1_data/OriginalDataset/1174_png.rf.d64420d6e694ef9c27c7637e9e70351c.jpg,115,252,28980,24209,4771
/media/gufran/GsHDD/Work/Projects/AI/PotholeSeverityClassification/Data/Step1_data/OriginalDataset/1185_png.rf.35770c8600d7cd18094f849fc3a8af85.jpg,121,202,24442,19448,4994
/media/gufran/GsHDD/Work/Projects/AI/PotholeSeverityClassification/Data/Step1_data/OriginalDataset/125_png.rf.44709318e8d2891a28bfecc66311a10c.jpg,523,631,330013,199762,130251
/media/gufran/GsHDD/Work/Projects/AI/PotholeSeverityClassification/Data/Step1_data/OriginalDataset/136_png.rf.49f4a756a8afe640a54c8bfb1c520f50.jpg,475,757,359575,274202,85373
/media/gufran/GsHDD/Work/Projects/AI/PotholeSeverityClassification/Data/Step1_data/OriginalDataset/137_png.rf.ac481da94dbc4407fd63d506d7781161.jpg,430,883,379690,269787,109903
/media/gufran/GsHDD/Work/Projects/AI/PotholeSeverityClassification/Data/Step1_data/OriginalDataset/140_png.rf.9861ef0b73b35d053d8852c3a6ac8c87.jpg,226,601,135826,104220,31606
/media/gufran/GsHDD/Work/Projects/AI/PotholeSeverityClassification/Data/Step1_data/OriginalDataset/140_png.rf.9861ef0b73b35d053d8852c3a6ac8c87.jpg,292,523,152716,117629,35087
/media/gufran/GsHDD/Work/Projects/AI/PotholeSeverityClassification/Data/Step1_data/OriginalDataset/147_png.rf.bb0fff7dcd4a09048c30088f2f3dd8bd.jpg,187,625,116875,92917,23958
/media/gufran/GsHDD/Work/Projects/AI/PotholeSeverityClassification/Data/Step1_data/OriginalDataset/14_png.rf.4a6a69140a2958310c91ba9ea4bb776f.jpg,355,238,84490,62075,22415
/media/gufran/GsHDD/Work/Projects/AI/PotholeSeverityClassification/Data/Step1_data/OriginalDataset/156_png.rf.f83387aa1714a17df58d087255c60273.jpg,169,429,72501,58342,14159
/media/gufran/GsHDD/Work/Projects/AI/PotholeSeverityClassification/Data/Step1_data/OriginalDataset/168_png.rf.e6668361f3167e9f31c2812af47cfd17.jpg,108,370,39960,30870,9090
/media/gufran/GsHDD/Work/Projects/AI/PotholeSeverityClassification/Data/Step1_data/OriginalDataset/169_png.rf.77a897dd10b9a5b469246626fbae7880.jpg,146,391,57086,44338,12748
/media/gufran/GsHDD/Work/Projects/AI/PotholeSeverityClassification/Data/Step1_data/OriginalDataset/170_png.rf.88e0e7deffc86f518e5e820cf3715431.jpg,167,421,70307,56255,14052
/media/gufran/GsHDD/Work/Projects/AI/PotholeSeverityClassification/Data/Step1_data/OriginalDataset/171_png.rf.c9f2eedcb3fb954fed9c91dedfe7a277.jpg,202,460,92920,75356,17564
/media/gufran/GsHDD/Work/Projects/AI/PotholeSeverityClassification/Data/Step1_data/OriginalDataset/172_png.rf.805d454b2bd1aaf75dd0c40a532f571b.jpg,239,505,120695,97486,23209
/media/gufran/GsHDD/Work/Projects/AI/PotholeSeverityClassification/Data/Step1_data/OriginalDataset/173_png.rf.0656e7b6210b094b0c676cc69c78081c.jpg,289,547,158083,128871,29212
/media/gufran/GsHDD/Work/Projects/AI/PotholeSeverityClassification/Data/Step1_data/OriginalDataset/175_png.rf.83a245b07ac307abbd725b57019e7055.jpg,242,634,153428,117863,35565
/media/gufran/GsHDD/Work/Projects/AI/PotholeSeverityClassification/Data/Step1_data/OriginalDataset/217_png.rf.8a0cf758585006af69d39f8afa484bc4.jpg,286,181,51766,39351,12415
/media/gufran/GsHDD/Work/Projects/AI/PotholeSeverityClassification/Data/Step1_data/OriginalDataset/21_png.rf.687718f7743d4d45e57838b00e6225f0.jpg,454,736,334144,198978,135166
/media/gufran/GsHDD/Work/Projects/AI/PotholeSeverityClassification/Data/Step1_data/OriginalDataset/224_png.rf.61b918aad4e6fde9971653fddbdaa15c.jpg,166,550,91300,55392,35908
/media/gufran/GsHDD/Work/Projects/AI/PotholeSeverityClassification/Data/Step1_data/OriginalDataset/225_png.rf.2f07ba8566ffff5d0370f516ce2dd902.jpg,211,568,119848,78736,41112
/media/gufran/GsHDD/Work/Projects/AI/PotholeSeverityClassification/Data/Step1_data/OriginalDataset/226_png.rf.b635d13eaa2341c461bc7414db677cd3.jpg,262,547,143314,94450,48864
/media/gufran/GsHDD/Work/Projects/AI/PotholeSeverityClassification/Data/Step1_data/OriginalDataset/226_png.rf.b635d13eaa2341c461bc7414db677cd3.jpg,277,430,119110,77988,41122
/media/gufran/GsHDD/Work/Projects/AI/PotholeSeverityClassification/Data/Step1_data/OriginalDataset/227_png.rf.165486971fc7ccbfc523aea289723c06.jpg,276,523,144348,101963,42385
/media/gufran/GsHDD/Work/Projects/AI/PotholeSeverityClassification/Data/Step1_data/OriginalDataset/227_png.rf.165486971fc7ccbfc523aea289723c06.jpg,355,375,133125,89721,43404
/media/gufran/GsHDD/Work/Projects/AI/PotholeSeverityClassification/Data/Step1_data/OriginalDataset/228_png.rf.9e22fbae97220927f302421730588125.jpg,310,484,150040,108685,41355
/media/gufran/GsHDD/Work/Projects/AI/PotholeSeverityClassification/Data/Step1_data/OriginalDataset/228_png.rf.9e22fbae97220927f302421730588125.jpg,340,308,104720,78839,25881
/media/gufran/GsHDD/Work/Projects/AI/PotholeSeverityClassification/Data/Step1_data/OriginalDataset/229_png.rf.6e4ca5568bda5014737f9197383f189f.jpg,359,469,168371,115161,53210
/media/gufran/GsHDD/Work/Projects/AI/PotholeSeverityClassification/Data/Step1_data/OriginalDataset/231_png.rf.b56bcef987525eebdd36a9307f3dbf80.jpg,251,382,95882,80881,15001
/media/gufran/GsHDD/Work/Projects/AI/PotholeSeverityClassification/Data/Step1_data/OriginalDataset/231_png.rf.b56bcef987525eebdd36a9307f3dbf80.jpg,132,262,34584,24812,9772
/media/gufran/GsHDD/Work/Projects/AI/PotholeSeverityClassification/Data/Step1_data/OriginalDataset/232_png.rf.f82425edeb0fff9f294c0f2cbd2fa366.jpg,148,280,41440,29281,12159
/media/gufran/GsHDD/Work/Projects/AI/PotholeSeverityClassification/Data/Step1_data/OriginalDataset/232_png.rf.f82425edeb0fff9f294c0f2cbd2fa366.jpg,135,283,38205,34828,3377
/media/gufran/GsHDD/Work/Projects/AI/PotholeSeverityClassification/Data/Step1_data/OriginalDataset/233_png.rf.c1b4f6d7eb8798621da39d16c22387be.jpg,169,313,52897,36032,16865
/media/gufran/GsHDD/Work/Projects/AI/PotholeSeverityClassification/Data/Step1_data/OriginalDataset/234_png.rf.1268556e731104f40a1f2ed21e4e8dc5.jpg,194,325,63050,43136,19914
/media/gufran/GsHDD/Work/Projects/AI/PotholeSeverityClassification/Data/Step1_data/OriginalDataset/236_png.rf.07f921451e0d7100ff601a56854edcc1.jpg,253,385,97405,69059,28346
/media/gufran/GsHDD/Work/Projects/AI/PotholeSeverityClassification/Data/Step1_data/OriginalDataset/237_png.rf.6ba7a73034e2784bc6a792d874d40042.jpg,229,433,99157,66212,32945
/media/gufran/GsHDD/Work/Projects/AI/PotholeSeverityClassification/Data/Step1_data/OriginalDataset/249_png.rf.ae1a530f3e8d63bbd25fcdd9f13ab9db.jpg,354,463,163902,101870,62032
/media/gufran/GsHDD/Work/Projects/AI/PotholeSeverityClassification/Data/Step1_data/OriginalDataset/253_png.rf.277ba73c63a8bbab3b62bb870fa9787a.jpg,105,397,41685,31012,10673
/media/gufran/GsHDD/Work/Projects/AI/PotholeSeverityClassification/Data/Step1_data/OriginalDataset/254_png.rf.11f46093c7214e5b34d175abe17996ca.jpg,169,433,73177,54128,19049
/media/gufran/GsHDD/Work/Projects/AI/PotholeSeverityClassification/Data/Step1_data/OriginalDataset/255_png.rf.b69081912aa1745a1f4c245fb165c0d1.jpg,208,391,81328,65983,15345
/media/gufran/GsHDD/Work/Projects/AI/PotholeSeverityClassification/Data/Step1_data/OriginalDataset/256_png.rf.365f4ea2c427ebf81d37b58ccd9e9cfa.jpg,537,532,285684,172107,113577
/media/gufran/GsHDD/Work/Projects/AI/PotholeSeverityClassification/Data/Step1_data/OriginalDataset/289_png.rf.347d630aa45b372251d9289236830819.jpg,229,235,53815,28702,25113
/media/gufran/GsHDD/Work/Projects/AI/PotholeSeverityClassification/Data/Step1_data/OriginalDataset/290_png.rf.eca960208f86c2135957f9948bd1e5bd.jpg,385,286,110110,62326,47784
/media/gufran/GsHDD/Work/Projects/AI/PotholeSeverityClassification/Data/Step1_data/OriginalDataset/311_png.rf.4508b8110649fc8b86cd0903fe5a9aa7.jpg,238,724,172312,111574,60738
/media/gufran/GsHDD/Work/Projects/AI/PotholeSeverityClassification/Data/Step1_data/OriginalDataset/384_png.rf.8e629e4be1e4f69cebf78e06fee77141.jpg,180,658,118440,88796,29644
/media/gufran/GsHDD/Work/Projects/AI/PotholeSeverityClassification/Data/Step1_data/OriginalDataset/385_png.rf.1987c62c9c2960a2398cc8bcf27cc3c7.jpg,211,712,150232,110694,39538
/media/gufran/GsHDD/Work/Projects/AI/PotholeSeverityClassification/Data/Step1_data/OriginalDataset/386_png.rf.c63f14164d81c9a1413487d0cdf4057c.jpg,249,724,180276,122267,58009
/media/gufran/GsHDD/Work/Projects/AI/PotholeSeverityClassification/Data/Step1_data/OriginalDataset/38_png.rf.3f29ffee299c4fc31d41354131a09cfa.jpg,417,359,149703,84520,65183
/media/gufran/GsHDD/Work/Projects/AI/PotholeSeverityClassification/Data/Step1_data/OriginalDataset/39_png.rf.cdf4f07a34a34be7fe876c6614a220f6.jpg,508,424,215392,132462,82930
/media/gufran/GsHDD/Work/Projects/AI/PotholeSeverityClassification/Data/Step1_data/OriginalDataset/3_png.rf.e967fd3b0917911f6b2160e81dbbf41f.jpg,276,197,54372,41671,12701
/media/gufran/GsHDD/Work/Projects/AI/PotholeSeverityClassification/Data/Step1_data/OriginalDataset/404_png.rf.078add547d446fe2ec47075dd453afd2.jpg,186,658,122388,101899,20489
/media/gufran/GsHDD/Work/Projects/AI/PotholeSeverityClassification/Data/Step1_data/OriginalDataset/40_png.rf.a3d90b7352a3066ba93cf2b76bb6ecd2.jpg,371,466,172886,120341,52545
/media/gufran/GsHDD/Work/Projects/AI/PotholeSeverityClassification/Data/Step1_data/OriginalDataset/416_png.rf.84cc2d1e7682c49d05dcde5e314699c7.jpg,85,253,21505,15807,5698
/media/gufran/GsHDD/Work/Projects/AI/PotholeSeverityClassification/Data/Step1_data/OriginalDataset/417_png.rf.300894d17ca9ba0bd31b57369790e115.jpg,96,256,24576,18722,5854
/media/gufran/GsHDD/Work/Projects/AI/PotholeSeverityClassification/Data/Step1_data/OriginalDataset/418_png.rf.98e7f180d11b027fe92f7ee91a6971b8.jpg,145,319,46255,35349,10906
/media/gufran/GsHDD/Work/Projects/AI/PotholeSeverityClassification/Data/Step1_data/OriginalDataset/428_png.rf.64fe5ea88edb8fd7c278c7a5ee572e28.jpg,166,169,28054,16873,11181
/media/gufran/GsHDD/Work/Projects/AI/PotholeSeverityClassification/Data/Step1_data/OriginalDataset/428_png.rf.64fe5ea88edb8fd7c278c7a5ee572e28.jpg,307,229,70303,45386,24917
/media/gufran/GsHDD/Work/Projects/AI/PotholeSeverityClassification/Data/Step1_data/OriginalDataset/429_png.rf.34accd4da1d744a210ad875d9b0726d4.jpg,268,212,56816,36769,20047
/media/gufran/GsHDD/Work/Projects/AI/PotholeSeverityClassification/Data/Step1_data/OriginalDataset/431_png.rf.c7728abc5f9682d0b83abf947e0a8505.jpg,322,298,95956,44125,51831
/media/gufran/GsHDD/Work/Projects/AI/PotholeSeverityClassification/Data/Step1_data/OriginalDataset/431_png.rf.c7728abc5f9682d0b83abf947e0a8505.jpg,120,379,45480,36093,9387
/media/gufran/GsHDD/Work/Projects/AI/PotholeSeverityClassification/Data/Step1_data/OriginalDataset/432_png.rf.cffe7d0406d459c74135c2fe2c6b2b38.jpg,162,391,63342,50532,12810
/media/gufran/GsHDD/Work/Projects/AI/PotholeSeverityClassification/Data/Step1_data/OriginalDataset/432_png.rf.cffe7d0406d459c74135c2fe2c6b2b38.jpg,376,325,122200,55451,66749
/media/gufran/GsHDD/Work/Projects/AI/PotholeSeverityClassification/Data/Step1_data/OriginalDataset/433_png.rf.bfc3f3fd56bcb42d0d2305b273943a76.jpg,199,424,84376,66869,17507
/media/gufran/GsHDD/Work/Projects/AI/PotholeSeverityClassification/Data/Step1_data/OriginalDataset/433_png.rf.bfc3f3fd56bcb42d0d2305b273943a76.jpg,374,343,128282,53766,74516
/media/gufran/GsHDD/Work/Projects/AI/PotholeSeverityClassification/Data/Step1_data/OriginalDataset/434_png.rf.f169a8e5221ee66b7423bd6bd84b214a.jpg,223,445,99235,78019,21216
/media/gufran/GsHDD/Work/Projects/AI/PotholeSeverityClassification/Data/Step1_data/OriginalDataset/434_png.rf.f169a8e5221ee66b7423bd6bd84b214a.jpg,319,328,104632,54840,49792
/media/gufran/GsHDD/Work/Projects/AI/PotholeSeverityClassification/Data/Step1_data/OriginalDataset/435_png.rf.cfde8c9f0eb694f560ca87eff64a3af1.jpg,268,481,128908,100450,28458
/media/gufran/GsHDD/Work/Projects/AI/PotholeSeverityClassification/Data/Step1_data/OriginalDataset/435_png.rf.cfde8c9f0eb694f560ca87eff64a3af1.jpg,274,337,92338,55772,36566
/media/gufran/GsHDD/Work/Projects/AI/PotholeSeverityClassification/Data/Step1_data/OriginalDataset/437_png.rf.8c7d639dfc7e36ef911d16c101cda67b.jpg,313,508,159004,120940,38064
/media/gufran/GsHDD/Work/Projects/AI/PotholeSeverityClassification/Data/Step1_data/OriginalDataset/437_png.rf.8c7d639dfc7e36ef911d16c101cda67b.jpg,418,373,155914,85307,70607
/media/gufran/GsHDD/Work/Projects/AI/PotholeSeverityClassification/Data/Step1_data/OriginalDataset/438_png.rf.42dd1ddfaa883ebfb707dcce860d4eff.jpg,361,541,195301,148332,46969
/media/gufran/GsHDD/Work/Projects/AI/PotholeSeverityClassification/Data/Step1_data/OriginalDataset/439_png.rf.ca02c44ff0d96ad0cfbe6379b9f6ee1d.jpg,332,592,196544,166202,30342
/media/gufran/GsHDD/Work/Projects/AI/PotholeSeverityClassification/Data/Step1_data/OriginalDataset/43_png.rf.acdf286fb20178c479e11adaebd1d944.jpg,351,142,49842,38343,11499
/media/gufran/GsHDD/Work/Projects/AI/PotholeSeverityClassification/Data/Step1_data/OriginalDataset/440_png.rf.5ca88a9af8f85fcb0fb68e15d31ab334.jpg,277,460,127420,82102,45318
/media/gufran/GsHDD/Work/Projects/AI/PotholeSeverityClassification/Data/Step1_data/OriginalDataset/441_png.rf.2804d85aa0a142866e0a7e64222ce683.jpg,324,490,158760,115789,42971
/media/gufran/GsHDD/Work/Projects/AI/PotholeSeverityClassification/Data/Step1_data/OriginalDataset/442_png.rf.728c714e2de4f6267498ec96af85ce4d.jpg,391,496,193936,145979,47957
/media/gufran/GsHDD/Work/Projects/AI/PotholeSeverityClassification/Data/Step1_data/OriginalDataset/442_png.rf.728c714e2de4f6267498ec96af85ce4d.jpg,337,307,103459,70500,32959
/media/gufran/GsHDD/Work/Projects/AI/PotholeSeverityClassification/Data/Step1_data/OriginalDataset/443_png.rf.8e6884c034b263a4f0373955b05a26df.jpg,256,658,168448,130019,38429
/media/gufran/GsHDD/Work/Projects/AI/PotholeSeverityClassification/Data/Step1_data/OriginalDataset/443_png.rf.8e6884c034b263a4f0373955b05a26df.jpg,157,574,90118,60251,29867
/media/gufran/GsHDD/Work/Projects/AI/PotholeSeverityClassification/Data/Step1_data/OriginalDataset/453_png.rf.2958c5228c178fe81ee4a747099e9423.jpg,232,295,68440,47425,21015
/media/gufran/GsHDD/Work/Projects/AI/PotholeSeverityClassification/Data/Step1_data/OriginalDataset/453_png.rf.2958c5228c178fe81ee4a747099e9423.jpg,208,271,56368,43914,12454
/media/gufran/GsHDD/Work/Projects/AI/PotholeSeverityClassification/Data/Step1_data/OriginalDataset/45_png.rf.e821286af06dd1521c96347f28be8381.jpg,487,169,82303,65708,16595
/media/gufran/GsHDD/Work/Projects/AI/PotholeSeverityClassification/Data/Step1_data/OriginalDataset/46_png.rf.b428a0978fd521481925b2f8a6cfcb60.jpg,424,202,85648,69983,15665
/media/gufran/GsHDD/Work/Projects/AI/PotholeSeverityClassification/Data/Step1_data/OriginalDataset/235_png.rf.3bdbee924a5fa89810def9aab4117ba6.jpg,226,367,82942,57990,24952
/media/gufran/GsHDD/Work/Projects/AI/PotholeSeverityClassification/Data/Step1_data/OriginalDataset/288_png.rf.01e11c64c53d463d858b6029d49badd8.jpg,339,409,138651,110070,28581
/media/gufran/GsHDD/Work/Projects/AI/PotholeSeverityClassification/Data/Step1_data/OriginalDataset/310_png.rf.346fbfa82e19bebd79dc0681fb657108.jpg,157,541,84937,47356,37581
/media/gufran/GsHDD/Work/Projects/AI/PotholeSeverityClassification/Data/Step1_data/OriginalDataset/405_png.rf.7dc986171cb47f9d05c68e7426c44289.jpg,230,715,164450,139274,25176
/media/gufran/GsHDD/Work/Projects/AI/PotholeSeverityClassification/Data/Step1_data/OriginalDataset/493_png.rf.3ba96f3e4b6d6235c6b25c62b52fe3ed.jpg,100,232,23200,17759,5441
/media/gufran/GsHDD/Work/Projects/AI/PotholeSeverityClassification/Data/Step1_data/OriginalDataset/503_png.rf.31b2dafa14680a6c98e765d9b24ce605.jpg,121,253,30613,20763,9850
/media/gufran/GsHDD/Work/Projects/AI/PotholeSeverityClassification/Data/Step1_data/OriginalDataset/508_png.rf.7ef32d11bae9f86bf935b5152b7a5a73.jpg,191,436,83276,61806,21470
/media/gufran/GsHDD/Work/Projects/AI/PotholeSeverityClassification/Data/Step1_data/OriginalDataset/509_png.rf.dc37c755f3f372ec6eab2eae1b12284e.jpg,223,454,101242,70616,30626
/media/gufran/GsHDD/Work/Projects/AI/PotholeSeverityClassification/Data/Step1_data/OriginalDataset/510_png.rf.11e80e9f73f5b381bc2cd2488846cecc.jpg,187,367,68629,54205,14424
/media/gufran/GsHDD/Work/Projects/AI/PotholeSeverityClassification/Data/Step1_data/OriginalDataset/510_png.rf.11e80e9f73f5b381bc2cd2488846cecc.jpg,219,367,80373,61034,19339
/media/gufran/GsHDD/Work/Projects/AI/PotholeSeverityClassification/Data/Step1_data/OriginalDataset/512_png.rf.8d1d2e6539f7b529f50a1f8af0f30bcb.jpg,239,412,98468,77470,20998
/media/gufran/GsHDD/Work/Projects/AI/PotholeSeverityClassification/Data/Step1_data/OriginalDataset/512_png.rf.8d1d2e6539f7b529f50a1f8af0f30bcb.jpg,268,409,109612,79820,29792
/media/gufran/GsHDD/Work/Projects/AI/PotholeSeverityClassification/Data/Step1_data/OriginalDataset/513_png.rf.96edbd66a9afac724a299d4cd76fe101.jpg,262,430,112660,89117,23543
/media/gufran/GsHDD/Work/Projects/AI/PotholeSeverityClassification/Data/Step1_data/OriginalDataset/513_png.rf.96edbd66a9afac724a299d4cd76fe101.jpg,280,430,120400,87753,32647
/media/gufran/GsHDD/Work/Projects/AI/PotholeSeverityClassification/Data/Step1_data/OriginalDataset/514_png.rf.f1989f88ee68fbbe85eda14c79e94b7e.jpg,290,443,128470,105161,23309
/media/gufran/GsHDD/Work/Projects/AI/PotholeSeverityClassification/Data/Step1_data/OriginalDataset/514_png.rf.f1989f88ee68fbbe85eda14c79e94b7e.jpg,322,457,147154,108901,38253
/media/gufran/GsHDD/Work/Projects/AI/PotholeSeverityClassification/Data/Step1_data/OriginalDataset/515_png.rf.654c33929bd15436a69274dbc4802534.jpg,332,472,156704,123454,33250
/media/gufran/GsHDD/Work/Projects/AI/PotholeSeverityClassification/Data/Step1_data/OriginalDataset/515_png.rf.654c33929bd15436a69274dbc4802534.jpg,397,490,194530,128903,65627
/media/gufran/GsHDD/Work/Projects/AI/PotholeSeverityClassification/Data/Step1_data/OriginalDataset/516_png.rf.5c7186b7618feff76b45db07c4db701b.jpg,385,553,212905,158653,54252
/media/gufran/GsHDD/Work/Projects/AI/PotholeSeverityClassification/Data/Step1_data/OriginalDataset/516_png.rf.5c7186b7618feff76b45db07c4db701b.jpg,361,505,182305,151367,30938
/media/gufran/GsHDD/Work/Projects/AI/PotholeSeverityClassification/Data/Step1_data/OriginalDataset/518_png.rf.db8d281af3292143173e9e51c56a17ef.jpg,310,545,168950,148723,20227
/media/gufran/GsHDD/Work/Projects/AI/PotholeSeverityClassification/Data/Step1_data/OriginalDataset/518_png.rf.db8d281af3292143173e9e51c56a17ef.jpg,353,587,207211,142192,65019
/media/gufran/GsHDD/Work/Projects/AI/PotholeSeverityClassification/Data/Step1_data/OriginalDataset/519_png.rf.3c08a6bf0bbe9b156bb8da00c0ce9b3b.jpg,265,568,150520,132362,18158
/media/gufran/GsHDD/Work/Projects/AI/PotholeSeverityClassification/Data/Step1_data/OriginalDataset/519_png.rf.3c08a6bf0bbe9b156bb8da00c0ce9b3b.jpg,313,553,173089,122859,50230
/media/gufran/GsHDD/Work/Projects/AI/PotholeSeverityClassification/Data/Step1_data/OriginalDataset/520_png.rf.917b1fcd5c4ca95729e0d1a632396a94.jpg,266,559,148694,99358,49336
/media/gufran/GsHDD/Work/Projects/AI/PotholeSeverityClassification/Data/Step1_data/OriginalDataset/520_png.rf.917b1fcd5c4ca95729e0d1a632396a94.jpg,220,604,132880,110135,22745
/media/gufran/GsHDD/Work/Projects/AI/PotholeSeverityClassification/Data/Step1_data/OriginalDataset/52_png.rf.ed7a55d059351b70dacd086f8aeb9d17.jpg,123,193,23739,19021,4718
/media/gufran/GsHDD/Work/Projects/AI/PotholeSeverityClassification/Data/Step1_data/OriginalDataset/531_png.rf.7c5e9e560a46820aa8108885c0a42ba9.jpg,220,283,62260,40940,21320
/media/gufran/GsHDD/Work/Projects/AI/PotholeSeverityClassification/Data/Step1_data/OriginalDataset/531_png.rf.7c5e9e560a46820aa8108885c0a42ba9.jpg,199,262,52138,41587,10551
/media/gufran/GsHDD/Work/Projects/AI/PotholeSeverityClassification/Data/Step1_data/OriginalDataset/534_png.rf.fc300a6cc9125acae7cf7663fa06a0fc.jpg,355,592,210160,159477,50683
/media/gufran/GsHDD/Work/Projects/AI/PotholeSeverityClassification/Data/Step1_data/OriginalDataset/534_png.rf.fc300a6cc9125acae7cf7663fa06a0fc.jpg,409,586,239674,162175,77499
/media/gufran/GsHDD/Work/Projects/AI/PotholeSeverityClassification/Data/Step1_data/OriginalDataset/536_png.rf.ac49e558db1d3d1ae45d1099b22aec6b.jpg,295,376,110920,83184,27736
/media/gufran/GsHDD/Work/Projects/AI/PotholeSeverityClassification/Data/Step1_data/OriginalDataset/537_png.rf.38b2e7d4d7e3cc71cd49cc5331d674fa.jpg,138,292,40296,31843,8453
/media/gufran/GsHDD/Work/Projects/AI/PotholeSeverityClassification/Data/Step1_data/OriginalDataset/543_png.rf.da57bfe4328e0d865dcea882562ef4c2.jpg,148,454,67192,57429,9763
/media/gufran/GsHDD/Work/Projects/AI/PotholeSeverityClassification/Data/Step1_data/OriginalDataset/548_png.rf.087150b58d72deaae3516e7fa7aca2ba.jpg,304,632,192128,108898,83230
/media/gufran/GsHDD/Work/Projects/AI/PotholeSeverityClassification/Data/Step1_data/OriginalDataset/54_png.rf.a9cf9cd9d55172c6250eb84a8b57e09f.jpg,444,823,365412,172275,193137
/media/gufran/GsHDD/Work/Projects/AI/PotholeSeverityClassification/Data/Step1_data/OriginalDataset/54_png.rf.a9cf9cd9d55172c6250eb84a8b57e09f.jpg,137,103,14111,9535,4576
/media/gufran/GsHDD/Work/Projects/AI/PotholeSeverityClassification/Data/Step1_data/OriginalDataset/551_png.rf.417bf7d1c3f0a6df5b6116468453d64b.jpg,97,226,21922,15978,5944
/media/gufran/GsHDD/Work/Projects/AI/PotholeSeverityClassification/Data/Step1_data/OriginalDataset/56_png.rf.619b5593a3d5a72d769f8265ce0cca9a.jpg,573,914,523722,267182,256540
/media/gufran/GsHDD/Work/Projects/AI/PotholeSeverityClassification/Data/Step1_data/OriginalDataset/57_png.rf.086fe4cf1c2860b944e1f20a70e08202.jpg,514,1016,522224,333430,188794
/media/gufran/GsHDD/Work/Projects/AI/PotholeSeverityClassification/Data/Step1_data/OriginalDataset/611_png.rf.8854b4f7a3efae92ef2dbcd6a5882b39.jpg,102,211,21522,16139,5383
/media/gufran/GsHDD/Work/Projects/AI/PotholeSeverityClassification/Data/Step1_data/OriginalDataset/511_png.rf.ce92bb75328a48e314592382bc57c13e.jpg,211,391,82501,66586,15915
/media/gufran/GsHDD/Work/Projects/AI/PotholeSeverityClassification/Data/Step1_data/OriginalDataset/511_png.rf.ce92bb75328a48e314592382bc57c13e.jpg,255,388,98940,72505,26435
/media/gufran/GsHDD/Work/Projects/AI/PotholeSeverityClassification/Data/Step1_data/OriginalDataset/550_png.rf.0c189391e6559c2265f4bda1c006ab5b.jpg,276,367,101292,84015,17277
/media/gufran/GsHDD/Work/Projects/AI/PotholeSeverityClassification/Data/Step1_data/OriginalDataset/633_png.rf.26c43db3964190e2a779b7c3f1b90cd7.jpg,126,193,24318,19664,4654
/media/gufran/GsHDD/Work/Projects/AI/PotholeSeverityClassification/Data/Step1_data/OriginalDataset/643_png.rf.5ca0b6c725053ea357d0619f115c49a2.jpg,150,250,37500,26013,11487
/media/gufran/GsHDD/Work/Projects/AI/PotholeSeverityClassification/Data/Step1_data/OriginalDataset/664_png.rf.8010aaa557829cdf165796ee30bd5e76.jpg,186,256,47616,33005,14611
/media/gufran/GsHDD/Work/Projects/AI/PotholeSeverityClassification/Data/Step1_data/OriginalDataset/664_png.rf.8010aaa557829cdf165796ee30bd5e76.jpg,160,238,38080,32710,5370
/media/gufran/GsHDD/Work/Projects/AI/PotholeSeverityClassification/Data/Step1_data/OriginalDataset/674_png.rf.9782a10792748baeddaac1d25b93dd0d.jpg,175,250,43750,37579,6171
/media/gufran/GsHDD/Work/Projects/AI/PotholeSeverityClassification/Data/Step1_data/OriginalDataset/674_png.rf.9782a10792748baeddaac1d25b93dd0d.jpg,193,242,46706,33699,13007
/media/gufran/GsHDD/Work/Projects/AI/PotholeSeverityClassification/Data/Step1_data/OriginalDataset/677_png.rf.9c9a4f6aee840e01411235b207ce4181.jpg,87,400,34800,24351,10449
/media/gufran/GsHDD/Work/Projects/AI/PotholeSeverityClassification/Data/Step1_data/OriginalDataset/678_png.rf.8643ce7527c3d2e9a983e7df4d136a34.jpg,103,442,45526,31402,14124
/media/gufran/GsHDD/Work/Projects/AI/PotholeSeverityClassification/Data/Step1_data/OriginalDataset/679_png.rf.dd191167b7121e7078e1bb74af6f3ba6.jpg,124,466,57784,37797,19987
/media/gufran/GsHDD/Work/Projects/AI/PotholeSeverityClassification/Data/Step1_data/OriginalDataset/680_png.rf.08887ae3fd5a1189e3eea716317ee215.jpg,133,490,65170,43418,21752
/media/gufran/GsHDD/Work/Projects/AI/PotholeSeverityClassification/Data/Step1_data/OriginalDataset/681_png.rf.417f8b999cadd4a1790e2298084e820d.jpg,148,490,72520,49110,23410
/media/gufran/GsHDD/Work/Projects/AI/PotholeSeverityClassification/Data/Step1_data/OriginalDataset/682_png.rf.b422dc784799d01fcff0d8f1f3dbccea.jpg,157,505,79285,55922,23363
/media/gufran/GsHDD/Work/Projects/AI/PotholeSeverityClassification/Data/Step1_data/OriginalDataset/683_png.rf.dc74c9041437b957ef7dcb9ab192de67.jpg,171,493,84303,61579,22724
/media/gufran/GsHDD/Work/Projects/AI/PotholeSeverityClassification/Data/Step1_data/OriginalDataset/685_png.rf.67dc5446bdb79d3234e7edb3fefa8910.jpg,208,277,57616,36076,21540
/media/gufran/GsHDD/Work/Projects/AI/PotholeSeverityClassification/Data/Step1_data/OriginalDataset/685_png.rf.67dc5446bdb79d3234e7edb3fefa8910.jpg,193,265,51145,40457,10688
/media/gufran/GsHDD/Work/Projects/AI/PotholeSeverityClassification/Data/Step1_data/OriginalDataset/686_png.rf.67a02c70600c046b65eb8342f58b9fa7.jpg,184,520,95680,73216,22464
/media/gufran/GsHDD/Work/Projects/AI/PotholeSeverityClassification/Data/Step1_data/OriginalDataset/687_png.rf.d6e33585b85a06223e479d7f5cf52118.jpg,184,553,101752,77375,24377
/media/gufran/GsHDD/Work/Projects/AI/PotholeSeverityClassification/Data/Step1_data/OriginalDataset/688_png.rf.a6d378ee3478adf5a720875f62509d1d.jpg,199,568,113032,82936,30096
/media/gufran/GsHDD/Work/Projects/AI/PotholeSeverityClassification/Data/Step1_data/OriginalDataset/689_png.rf.46cb86776970139dbf253a2754ae89d5.jpg,208,568,118144,87812,30332
/media/gufran/GsHDD/Work/Projects/AI/PotholeSeverityClassification/Data/Step1_data/OriginalDataset/690_png.rf.91f5bb446b9fe894ef95f0ea8f4a4215.jpg,211,559,117949,89228,28721
/media/gufran/GsHDD/Work/Projects/AI/PotholeSeverityClassification/Data/Step1_data/OriginalDataset/691_png.rf.a958451937da043717fc094214a0e43c.jpg,223,586,130678,96140,34538
/media/gufran/GsHDD/Work/Projects/AI/PotholeSeverityClassification/Data/Step1_data/OriginalDataset/692_png.rf.f54c981d6911d07a4cf7c539b6986f1d.jpg,221,601,132821,100669,32152
/media/gufran/GsHDD/Work/Projects/AI/PotholeSeverityClassification/Data/Step1_data/OriginalDataset/693_png.rf.7ddabc09cf6661745e95f0ec6ceaf393.jpg,235,613,144055,109207,34848
/media/gufran/GsHDD/Work/Projects/AI/PotholeSeverityClassification/Data/Step1_data/OriginalDataset/694_png.rf.916c9668641bee3b89c2fd904ce8231b.jpg,235,628,147580,114060,33520
/media/gufran/GsHDD/Work/Projects/AI/PotholeSeverityClassification/Data/Step1_data/OriginalDataset/695_png.rf.d92e17c581fb626d493662f5457d8498.jpg,253,637,161161,121279,39882
/media/gufran/GsHDD/Work/Projects/AI/PotholeSeverityClassification/Data/Step1_data/OriginalDataset/695_png.rf.d92e17c581fb626d493662f5457d8498.jpg,139,562,78118,51707,26411
/media/gufran/GsHDD/Work/Projects/AI/PotholeSeverityClassification/Data/Step1_data/OriginalDataset/718_png.rf.919572849f633b613dd244c0d3d8d296.jpg,268,313,83884,56387,27497
/media/gufran/GsHDD/Work/Projects/AI/PotholeSeverityClassification/Data/Step1_data/OriginalDataset/718_png.rf.919572849f633b613dd244c0d3d8d296.jpg,247,295,72865,57485,15380
/media/gufran/GsHDD/Work/Projects/AI/PotholeSeverityClassification/Data/Step1_data/OriginalDataset/721_png.rf.4760514a0dcb084ec2bbca80b794e4a0.jpg,123,322,39606,30045,9561
/media/gufran/GsHDD/Work/Projects/AI/PotholeSeverityClassification/Data/Step1_data/OriginalDataset/721_png.rf.4760514a0dcb084ec2bbca80b794e4a0.jpg,118,388,45784,33679,12105
/media/gufran/GsHDD/Work/Projects/AI/PotholeSeverityClassification/Data/Step1_data/OriginalDataset/722_png.rf.9a76cea1f16630b5bd6af5df88ca3fb1.jpg,138,415,57270,40880,16390
/media/gufran/GsHDD/Work/Projects/AI/PotholeSeverityClassification/Data/Step1_data/OriginalDataset/722_png.rf.9a76cea1f16630b5bd6af5df88ca3fb1.jpg,141,343,48363,35614,12749
/media/gufran/GsHDD/Work/Projects/AI/PotholeSeverityClassification/Data/Step1_data/OriginalDataset/723_png.rf.750838d6df6208d749779a0b1f78ac3e.jpg,159,409,65031,47563,17468
/media/gufran/GsHDD/Work/Projects/AI/PotholeSeverityClassification/Data/Step1_data/OriginalDataset/723_png.rf.750838d6df6208d749779a0b1f78ac3e.jpg,168,355,59640,44102,15538
/media/gufran/GsHDD/Work/Projects/AI/PotholeSeverityClassification/Data/Step1_data/OriginalDataset/724_png.rf.607a0bdd0de12346614cec29142edcc5.jpg,189,358,67662,50618,17044
/media/gufran/GsHDD/Work/Projects/AI/PotholeSeverityClassification/Data/Step1_data/OriginalDataset/724_png.rf.607a0bdd0de12346614cec29142edcc5.jpg,174,421,73254,53567,19687
/media/gufran/GsHDD/Work/Projects/AI/PotholeSeverityClassification/Data/Step1_data/OriginalDataset/725_png.rf.1b0538e6ee291d62c7f74a9350ed7da2.jpg,192,424,81408,60220,21188
/media/gufran/GsHDD/Work/Projects/AI/PotholeSeverityClassification/Data/Step1_data/OriginalDataset/725_png.rf.1b0538e6ee291d62c7f74a9350ed7da2.jpg,207,364,75348,56722,18626
/media/gufran/GsHDD/Work/Projects/AI/PotholeSeverityClassification/Data/Step1_data/OriginalDataset/726_png.rf.b8d224c506674a74b703852e03ac9481.jpg,211,433,91363,66920,24443
/media/gufran/GsHDD/Work/Projects/AI/PotholeSeverityClassification/Data/Step1_data/OriginalDataset/726_png.rf.b8d224c506674a74b703852e03ac9481.jpg,225,406,91350,64932,26418
/media/gufran/GsHDD/Work/Projects/AI/PotholeSeverityClassification/Data/Step1_data/OriginalDataset/727_png.rf.cae19262b2ad4a6405f2b4eacca571bf.jpg,223,457,101911,73680,28231
/media/gufran/GsHDD/Work/Projects/AI/PotholeSeverityClassification/Data/Step1_data/OriginalDataset/727_png.rf.cae19262b2ad4a6405f2b4eacca571bf.jpg,259,430,111370,76419,34951
/media/gufran/GsHDD/Work/Projects/AI/PotholeSeverityClassification/Data/Step1_data/OriginalDataset/728_png.rf.03adad89cc69db0ed92fddabc29436b6.jpg,259,475,123025,85683,37342
/media/gufran/GsHDD/Work/Projects/AI/PotholeSeverityClassification/Data/Step1_data/OriginalDataset/728_png.rf.03adad89cc69db0ed92fddabc29436b6.jpg,280,427,119560,83647,35913
/media/gufran/GsHDD/Work/Projects/AI/PotholeSeverityClassification/Data/Step1_data/OriginalDataset/729_png.rf.10bf96a4a1aaf4b8b00847ca68290db4.jpg,277,316,87532,60577,26955
/media/gufran/GsHDD/Work/Projects/AI/PotholeSeverityClassification/Data/Step1_data/OriginalDataset/729_png.rf.10bf96a4a1aaf4b8b00847ca68290db4.jpg,256,301,77056,58068,18988
/media/gufran/GsHDD/Work/Projects/AI/PotholeSeverityClassification/Data/Step1_data/OriginalDataset/730_png.rf.67df0ad56362d00cc65c5bc890e87123.jpg,271,485,131435,94901,36534
/media/gufran/GsHDD/Work/Projects/AI/PotholeSeverityClassification/Data/Step1_data/OriginalDataset/730_png.rf.67df0ad56362d00cc65c5bc890e87123.jpg,301,454,136654,91909,44745
/media/gufran/GsHDD/Work/Projects/AI/PotholeSeverityClassification/Data/Step1_data/OriginalDataset/731_png.rf.7b7001adfd67a7a68b2d16ee5ed9a62c.jpg,286,499,142714,102871,39843
/media/gufran/GsHDD/Work/Projects/AI/PotholeSeverityClassification/Data/Step1_data/OriginalDataset/731_png.rf.7b7001adfd67a7a68b2d16ee5ed9a62c.jpg,334,481,160654,103459,57195
/media/gufran/GsHDD/Work/Projects/AI/PotholeSeverityClassification/Data/Step1_data/OriginalDataset/733_png.rf.bbfab5fe97e79f3c7ed2421c1f340f94.jpg,364,481,175084,115436,59648
/media/gufran/GsHDD/Work/Projects/AI/PotholeSeverityClassification/Data/Step1_data/OriginalDataset/733_png.rf.bbfab5fe97e79f3c7ed2421c1f340f94.jpg,322,514,165508,121085,44423
/media/gufran/GsHDD/Work/Projects/AI/PotholeSeverityClassification/Data/Step1_data/OriginalDataset/734_png.rf.5415d3ae0e6d1234bca2ffa490a3303d.jpg,334,514,171676,130262,41414
/media/gufran/GsHDD/Work/Projects/AI/PotholeSeverityClassification/Data/Step1_data/OriginalDataset/734_png.rf.5415d3ae0e6d1234bca2ffa490a3303d.jpg,391,523,204493,126253,78240
/media/gufran/GsHDD/Work/Projects/AI/PotholeSeverityClassification/Data/Step1_data/OriginalDataset/735_png.rf.ff029f182a3497ac9efc410b4bad5d95.jpg,334,508,169672,127422,42250
/media/gufran/GsHDD/Work/Projects/AI/PotholeSeverityClassification/Data/Step1_data/OriginalDataset/735_png.rf.ff029f182a3497ac9efc410b4bad5d95.jpg,427,490,209230,135768,73462
/media/gufran/GsHDD/Work/Projects/AI/PotholeSeverityClassification/Data/Step1_data/OriginalDataset/736_png.rf.d0006d6fe05f5d76fc2c05146af93597.jpg,394,625,246250,159657,86593
/media/gufran/GsHDD/Work/Projects/AI/PotholeSeverityClassification/Data/Step1_data/OriginalDataset/736_png.rf.d0006d6fe05f5d76fc2c05146af93597.jpg,340,673,228820,165418,63402
/media/gufran/GsHDD/Work/Projects/AI/PotholeSeverityClassification/Data/Step1_data/OriginalDataset/737_png.rf.55ec34984ee13d378d1fdf82c0fad659.jpg,320,628,200960,150879,50081
/media/gufran/GsHDD/Work/Projects/AI/PotholeSeverityClassification/Data/Step1_data/OriginalDataset/737_png.rf.55ec34984ee13d378d1fdf82c0fad659.jpg,361,640,231040,152813,78227
/media/gufran/GsHDD/Work/Projects/AI/PotholeSeverityClassification/Data/Step1_data/OriginalDataset/738_png.rf.3d809f15da791ab816ae18fc341a8dbc.jpg,287,659,189133,133680,55453
/media/gufran/GsHDD/Work/Projects/AI/PotholeSeverityClassification/Data/Step1_data/OriginalDataset/738_png.rf.3d809f15da791ab816ae18fc341a8dbc.jpg,344,655,225320,142310,83010
/media/gufran/GsHDD/Work/Projects/AI/PotholeSeverityClassification/Data/Step1_data/OriginalDataset/739_png.rf.6196171aa4c8cc77c30949cc373f90c4.jpg,295,328,96760,65062,31698
/media/gufran/GsHDD/Work/Projects/AI/PotholeSeverityClassification/Data/Step1_data/OriginalDataset/739_png.rf.6196171aa4c8cc77c30949cc373f90c4.jpg,265,289,76585,63650,12935
/media/gufran/GsHDD/Work/Projects/AI/PotholeSeverityClassification/Data/Step1_data/OriginalDataset/740_png.rf.f207eb17096b5b6d6bb48ac50062ed8a.jpg,262,661,173182,120369,52813
/media/gufran/GsHDD/Work/Projects/AI/PotholeSeverityClassification/Data/Step1_data/OriginalDataset/740_png.rf.f207eb17096b5b6d6bb48ac50062ed8a.jpg,322,604,194488,129583,64905
/media/gufran/GsHDD/Work/Projects/AI/PotholeSeverityClassification/Data/Step1_data/OriginalDataset/741_png.rf.d7ff16d95d29bfc9e892a95c9849630a.jpg,307,586,179902,117094,62808
/media/gufran/GsHDD/Work/Projects/AI/PotholeSeverityClassification/Data/Step1_data/OriginalDataset/741_png.rf.d7ff16d95d29bfc9e892a95c9849630a.jpg,243,641,155763,103727,52036
/media/gufran/GsHDD/Work/Projects/AI/PotholeSeverityClassification/Data/Step1_data/OriginalDataset/742_png.rf.f785d08b495cdf0b7b9133636e57141b.jpg,274,523,143302,101940,41362
/media/gufran/GsHDD/Work/Projects/AI/PotholeSeverityClassification/Data/Step1_data/OriginalDataset/742_png.rf.f785d08b495cdf0b7b9133636e57141b.jpg,194,569,110386,79577,30809
/media/gufran/GsHDD/Work/Projects/AI/PotholeSeverityClassification/Data/Step1_data/OriginalDataset/743_png.rf.adea6a0d054e03555556be3979ddc98e.jpg,241,550,132550,86325,46225
/media/gufran/GsHDD/Work/Projects/AI/PotholeSeverityClassification/Data/Step1_data/OriginalDataset/743_png.rf.adea6a0d054e03555556be3979ddc98e.jpg,173,533,92209,59877,32332
/media/gufran/GsHDD/Work/Projects/AI/PotholeSeverityClassification/Data/Step1_data/OriginalDataset/684_png.rf.64f8e382beba2a3c6af92f6e8c6de7f9.jpg,174,511,88914,67383,21531
/media/gufran/GsHDD/Work/Projects/AI/PotholeSeverityClassification/Data/Step1_data/OriginalDataset/696_png.rf.c1e5495c35708191d8582545416b23c5.jpg,244,298,72712,48438,24274
/media/gufran/GsHDD/Work/Projects/AI/PotholeSeverityClassification/Data/Step1_data/OriginalDataset/696_png.rf.c1e5495c35708191d8582545416b23c5.jpg,218,274,59732,46721,13011
/media/gufran/GsHDD/Work/Projects/AI/PotholeSeverityClassification/Data/Step1_data/OriginalDataset/708_png.rf.39b2a9953f73962a4a505ddde9f3cc7d.jpg,250,316,79000,53132,25868
/media/gufran/GsHDD/Work/Projects/AI/PotholeSeverityClassification/Data/Step1_data/OriginalDataset/708_png.rf.39b2a9953f73962a4a505ddde9f3cc7d.jpg,232,289,67048,51091,15957
/media/gufran/GsHDD/Work/Projects/AI/PotholeSeverityClassification/Data/Step1_data/OriginalDataset/720_png.rf.70dae0c3861b9746f6557ae87d2273d8.jpg,103,280,28840,21642,7198
/media/gufran/GsHDD/Work/Projects/AI/PotholeSeverityClassification/Data/Step1_data/OriginalDataset/720_png.rf.70dae0c3861b9746f6557ae87d2273d8.jpg,99,313,30987,22775,8212
/media/gufran/GsHDD/Work/Projects/AI/PotholeSeverityClassification/Data/Step1_data/OriginalDataset/760_png.rf.ed95238b4b2913ad0430ecfaac21ffad.jpg,334,355,118570,70244,48326
/media/gufran/GsHDD/Work/Projects/AI/PotholeSeverityClassification/Data/Step1_data/OriginalDataset/760_png.rf.ed95238b4b2913ad0430ecfaac21ffad.jpg,295,308,90860,75136,15724
/media/gufran/GsHDD/Work/Projects/AI/PotholeSeverityClassification/Data/Step1_data/OriginalDataset/762_png.rf.6e9f979a7d10e6be7f41ab61b26e0d43.jpg,288,331,95328,56743,38585
/media/gufran/GsHDD/Work/Projects/AI/PotholeSeverityClassification/Data/Step1_data/OriginalDataset/763_png.rf.6bc9401589584ea57525c96732448e56.jpg,373,367,136891,82195,54696
/media/gufran/GsHDD/Work/Projects/AI/PotholeSeverityClassification/Data/Step1_data/OriginalDataset/764_png.rf.3406aba2e37ae0320d28ff708b03c61c.jpg,412,439,180868,112910,67958
/media/gufran/GsHDD/Work/Projects/AI/PotholeSeverityClassification/Data/Step1_data/OriginalDataset/765_png.rf.93285ff32ea38300c01d3d47a5bf321e.jpg,301,302,90902,62184,28718
/media/gufran/GsHDD/Work/Projects/AI/PotholeSeverityClassification/Data/Step1_data/OriginalDataset/766_png.rf.2eb423f2dadeda8e3ea8f235f6ee524c.jpg,373,430,160390,116130,44260
/media/gufran/GsHDD/Work/Projects/AI/PotholeSeverityClassification/Data/Step1_data/OriginalDataset/767_png.rf.2bf27889b159eaf130f11546c9d0aa97.jpg,364,424,154336,113838,40498
/media/gufran/GsHDD/Work/Projects/AI/PotholeSeverityClassification/Data/Step1_data/OriginalDataset/768_png.rf.f1c7187d96c8bbcaf30c9f101fdcfc16.jpg,349,421,146929,109003,37926
/media/gufran/GsHDD/Work/Projects/AI/PotholeSeverityClassification/Data/Step1_data/OriginalDataset/769_png.rf.9634d679dc000f6288039dc52d3f45dd.jpg,340,406,138040,104942,33098
/media/gufran/GsHDD/Work/Projects/AI/PotholeSeverityClassification/Data/Step1_data/OriginalDataset/770_png.rf.e386f2d0eae528d434a88362bd5682ce.jpg,331,403,133393,101491,31902
/media/gufran/GsHDD/Work/Projects/AI/PotholeSeverityClassification/Data/Step1_data/OriginalDataset/771_png.rf.b1ebe87587988bb5c3cf357b8ede2dda.jpg,361,358,129238,87195,42043
/media/gufran/GsHDD/Work/Projects/AI/PotholeSeverityClassification/Data/Step1_data/OriginalDataset/771_png.rf.b1ebe87587988bb5c3cf357b8ede2dda.jpg,319,328,104632,86856,17776
/media/gufran/GsHDD/Work/Projects/AI/PotholeSeverityClassification/Data/Step1_data/OriginalDataset/773_png.rf.aff6ec2e52b302bb68e36310f4821581.jpg,316,397,125452,93366,32086
/media/gufran/GsHDD/Work/Projects/AI/PotholeSeverityClassification/Data/Step1_data/OriginalDataset/774_png.rf.3f9a650bbee06133cdfc36ba0bb111b0.jpg,313,391,122383,90798,31585
/media/gufran/GsHDD/Work/Projects/AI/PotholeSeverityClassification/Data/Step1_data/OriginalDataset/775_png.rf.ae938ecab85ad9906ff3774247f51b05.jpg,304,382,116128,87698,28430
/media/gufran/GsHDD/Work/Projects/AI/PotholeSeverityClassification/Data/Step1_data/OriginalDataset/776_png.rf.d81bbd1900a041bf8b165339e6c9b069.jpg,292,370,108040,81064,26976
/media/gufran/GsHDD/Work/Projects/AI/PotholeSeverityClassification/Data/Step1_data/OriginalDataset/777_png.rf.5582141d096232e5be4987b8cbca2d43.jpg,283,367,103861,78336,25525
/media/gufran/GsHDD/Work/Projects/AI/PotholeSeverityClassification/Data/Step1_data/OriginalDataset/778_png.rf.1e97cb78e24eea47cdea69a59edfec8d.jpg,274,364,99736,75834,23902
/media/gufran/GsHDD/Work/Projects/AI/PotholeSeverityClassification/Data/Step1_data/OriginalDataset/779_png.rf.150bc1ea928dcc46715119e6447b125e.jpg,271,358,97018,73345,23673
/media/gufran/GsHDD/Work/Projects/AI/PotholeSeverityClassification/Data/Step1_data/OriginalDataset/780_png.rf.7504a17cc1c2b98973e1520eccbf322e.jpg,268,349,93532,71401,22131
/media/gufran/GsHDD/Work/Projects/AI/PotholeSeverityClassification/Data/Step1_data/OriginalDataset/781_png.rf.04218afd36dd9e801c9849bd39def8ac.jpg,346,370,128020,90597,37423
/media/gufran/GsHDD/Work/Projects/AI/PotholeSeverityClassification/Data/Step1_data/OriginalDataset/781_png.rf.04218afd36dd9e801c9849bd39def8ac.jpg,295,337,99415,83904,15511
/media/gufran/GsHDD/Work/Projects/AI/PotholeSeverityClassification/Data/Step1_data/OriginalDataset/782_png.rf.57714c817e3ba323fdf386ec90173a93.jpg,265,352,93280,70921,22359
/media/gufran/GsHDD/Work/Projects/AI/PotholeSeverityClassification/Data/Step1_data/OriginalDataset/784_png.rf.0e37fd1dd64172e66c2d90e6a699ec1c.jpg,252,340,85680,66087,19593
/media/gufran/GsHDD/Work/Projects/AI/PotholeSeverityClassification/Data/Step1_data/OriginalDataset/785_png.rf.2337f761914143964807fe744f5cb12c.jpg,240,334,80160,62585,17575
/media/gufran/GsHDD/Work/Projects/AI/PotholeSeverityClassification/Data/Step1_data/OriginalDataset/786_png.rf.f69d1d798bff4e36803e925a17f5fed6.jpg,231,325,75075,59394,15681
/media/gufran/GsHDD/Work/Projects/AI/PotholeSeverityClassification/Data/Step1_data/OriginalDataset/787_png.rf.f7f88baa5a8003bcccfe5049e1375cbf.jpg,216,319,68904,56314,12590
/media/gufran/GsHDD/Work/Projects/AI/PotholeSeverityClassification/Data/Step1_data/OriginalDataset/788_png.rf.393577e3a7850f047613134ba4f7f72a.jpg,201,310,62310,52222,10088
/media/gufran/GsHDD/Work/Projects/AI/PotholeSeverityClassification/Data/Step1_data/OriginalDataset/789_png.rf.eefaa9fa3b620cc33e31a2d620c7157e.jpg,201,310,62310,48918,13392
/media/gufran/GsHDD/Work/Projects/AI/PotholeSeverityClassification/Data/Step1_data/OriginalDataset/790_png.rf.24e3d55048a003ab8704ca0a701a1d84.jpg,183,307,56181,46506,9675
/media/gufran/GsHDD/Work/Projects/AI/PotholeSeverityClassification/Data/Step1_data/OriginalDataset/791_png.rf.19329d9814a87aff4dea89cd399b9958.jpg,180,301,54180,43751,10429
/media/gufran/GsHDD/Work/Projects/AI/PotholeSeverityClassification/Data/Step1_data/OriginalDataset/792_png.rf.956e527bfc8ba1ac94baf57d940140e9.jpg,319,379,120901,83096,37805
/media/gufran/GsHDD/Work/Projects/AI/PotholeSeverityClassification/Data/Step1_data/OriginalDataset/792_png.rf.956e527bfc8ba1ac94baf57d940140e9.jpg,272,424,115328,86352,28976
/media/gufran/GsHDD/Work/Projects/AI/PotholeSeverityClassification/Data/Step1_data/OriginalDataset/793_png.rf.740c1d3d7cd712871709fa56db839ebf.jpg,168,301,50568,40775,9793
/media/gufran/GsHDD/Work/Projects/AI/PotholeSeverityClassification/Data/Step1_data/OriginalDataset/795_png.rf.db5571397bc8534068a39e4a0256887a.jpg,148,292,43216,34448,8768
/media/gufran/GsHDD/Work/Projects/AI/PotholeSeverityClassification/Data/Step1_data/OriginalDataset/796_png.rf.17db1fbb534e7201b91e819586240e33.jpg,127,286,36322,28794,7528
/media/gufran/GsHDD/Work/Projects/AI/PotholeSeverityClassification/Data/Step1_data/OriginalDataset/797_png.rf.0dd1249d6eb75917bf2c572108ca8dcf.jpg,118,283,33394,26194,7200
/media/gufran/GsHDD/Work/Projects/AI/PotholeSeverityClassification/Data/Step1_data/OriginalDataset/798_png.rf.c9096a1685ab8552aca84f491a1529f3.jpg,100,274,27400,22025,5375
/media/gufran/GsHDD/Work/Projects/AI/PotholeSeverityClassification/Data/Step1_data/OriginalDataset/799_png.rf.01833f94eac41aa3fde39bf789612a4f.jpg,94,271,25474,19760,5714
/media/gufran/GsHDD/Work/Projects/AI/PotholeSeverityClassification/Data/Step1_data/OriginalDataset/800_png.rf.07372e2284ab6b3e39e396a7335b9bd6.jpg,84,265,22260,17451,4809
/media/gufran/GsHDD/Work/Projects/AI/PotholeSeverityClassification/Data/Step1_data/OriginalDataset/801_png.rf.bc360e9e320064ab82edd925ccc3926c.jpg,79,262,20698,15292,5406
/media/gufran/GsHDD/Work/Projects/AI/PotholeSeverityClassification/Data/Step1_data/OriginalDataset/802_png.rf.596255e528fcf2befa522e9af8f15edd.jpg,296,385,113960,71737,42223
/media/gufran/GsHDD/Work/Projects/AI/PotholeSeverityClassification/Data/Step1_data/OriginalDataset/802_png.rf.596255e528fcf2befa522e9af8f15edd.jpg,250,418,104500,77241,27259
/media/gufran/GsHDD/Work/Projects/AI/PotholeSeverityClassification/Data/Step1_data/OriginalDataset/814_png.rf.2229e3457109bebe407649ad48d46f4f.jpg,274,391,107134,63025,44109
/media/gufran/GsHDD/Work/Projects/AI/PotholeSeverityClassification/Data/Step1_data/OriginalDataset/818_png.rf.31c66583ae6eb8efaf404df02f32933c.jpg,52,109,5668,4537,1131
/media/gufran/GsHDD/Work/Projects/AI/PotholeSeverityClassification/Data/Step1_data/OriginalDataset/819_png.rf.fc277c2d41daee412c22867b2d5a2ade.jpg,70,106,7420,5804,1616
/media/gufran/GsHDD/Work/Projects/AI/PotholeSeverityClassification/Data/Step1_data/OriginalDataset/820_png.rf.8dbd911333e731230162732f6e82ec27.jpg,65,106,6890,5482,1408
/media/gufran/GsHDD/Work/Projects/AI/PotholeSeverityClassification/Data/Step1_data/OriginalDataset/821_png.rf.b68ef1ad96394dd9972e5d64a2e9e385.jpg,61,97,5917,4795,1122
/media/gufran/GsHDD/Work/Projects/AI/PotholeSeverityClassification/Data/Step1_data/OriginalDataset/823_png.rf.ab0f6ef36385b70c93a2ac0984597d45.jpg,52,97,5044,3911,1133
/media/gufran/GsHDD/Work/Projects/AI/PotholeSeverityClassification/Data/Step1_data/OriginalDataset/824_png.rf.4a6f3115b323852eadb456e84623d7bc.jpg,241,331,79771,49174,30597
/media/gufran/GsHDD/Work/Projects/AI/PotholeSeverityClassification/Data/Step1_data/OriginalDataset/824_png.rf.4a6f3115b323852eadb456e84623d7bc.jpg,175,439,76825,52738,24087
/media/gufran/GsHDD/Work/Projects/AI/PotholeSeverityClassification/Data/Step1_data/OriginalDataset/825_png.rf.7be5455ca88b25293bdb0653929d3671.jpg,52,88,4576,3750,826
/media/gufran/GsHDD/Work/Projects/AI/PotholeSeverityClassification/Data/Step1_data/OriginalDataset/827_png.rf.eabbf2b123229c05ddd7f57d3a1e9aa6.jpg,50,88,4400,3464,936
/media/gufran/GsHDD/Work/Projects/AI/PotholeSeverityClassification/Data/Step1_data/OriginalDataset/847_png.rf.06939c61002851f2c964c185c23b55d7.jpg,67,100,6700,5512,1188
/media/gufran/GsHDD/Work/Projects/AI/PotholeSeverityClassification/Data/Step1_data/OriginalDataset/84_png.rf.b0aab69349501daf13ec0aaa29971cbb.jpg,418,745,311410,235858,75552
/media/gufran/GsHDD/Work/Projects/AI/PotholeSeverityClassification/Data/Step1_data/OriginalDataset/85_png.rf.0c1e2922a519e76986cbccf497e51f97.jpg,478,778,371884,291977,79907
/media/gufran/GsHDD/Work/Projects/AI/PotholeSeverityClassification/Data/Step1_data/OriginalDataset/86_png.rf.9d583040f230b185b0cbda16e5d8fa50.jpg,556,799,444244,361428,82816
/media/gufran/GsHDD/Work/Projects/AI/PotholeSeverityClassification/Data/Step1_data/OriginalDataset/750_png.rf.94e80b0bccabfa268437c5ab61b2d3f5.jpg,313,340,106420,70326,36094
/media/gufran/GsHDD/Work/Projects/AI/PotholeSeverityClassification/Data/Step1_data/OriginalDataset/750_png.rf.94e80b0bccabfa268437c5ab61b2d3f5.jpg,280,307,85960,71916,14044
/media/gufran/GsHDD/Work/Projects/AI/PotholeSeverityClassification/Data/Step1_data/OriginalDataset/761_png.rf.5bf0e8401511e74d3fb4dba2aeb0a61d.jpg,177,298,52746,33151,19595
/media/gufran/GsHDD/Work/Projects/AI/PotholeSeverityClassification/Data/Step1_data/OriginalDataset/772_png.rf.2ed319b88f057c45bfbd433c18116643.jpg,325,397,129025,97104,31921
/media/gufran/GsHDD/Work/Projects/AI/PotholeSeverityClassification/Data/Step1_data/OriginalDataset/783_png.rf.bb1e6140e76a3974de7af684b55e90f5.jpg,259,346,89614,68355,21259
/media/gufran/GsHDD/Work/Projects/AI/PotholeSeverityClassification/Data/Step1_data/OriginalDataset/794_png.rf.ba981d671e73280e56cf3f3fb54e550a.jpg,159,295,46905,37457,9448
/media/gufran/GsHDD/Work/Projects/AI/PotholeSeverityClassification/Data/Step1_data/OriginalDataset/83_png.rf.287298f3b1d6dfddae012cf3e7af717d.jpg,351,691,242541,175553,66988
/media/gufran/GsHDD/Work/Projects/AI/PotholeSeverityClassification/Data/Step1_data/OriginalDataset/945_png.rf.1f16f7edef4aba83843d1319f8d94e59.jpg,206,658,135548,98184,37364
/media/gufran/GsHDD/Work/Projects/AI/PotholeSeverityClassification/Data/Step1_data/OriginalDataset/945_png.rf.1f16f7edef4aba83843d1319f8d94e59.jpg,109,478,52102,40641,11461
/media/gufran/GsHDD/Work/Projects/AI/PotholeSeverityClassification/Data/Step1_data/OriginalDataset/924_png.rf.f0648db09ccff15eb1de4b0029327722.jpg,196,682,133672,95892,37780
/media/gufran/GsHDD/Work/Projects/AI/PotholeSeverityClassification/Data/Step1_data/OriginalDataset/925_png.rf.eca5b569d8bea4d2f19d8a8918d60590.jpg,276,688,189888,138385,51503
/media/gufran/GsHDD/Work/Projects/AI/PotholeSeverityClassification/Data/Step1_data/OriginalDataset/926_png.rf.0c15f67002adb660b670aa2f718e2764.jpg,346,688,238048,175366,62682
/media/gufran/GsHDD/Work/Projects/AI/PotholeSeverityClassification/Data/Step1_data/OriginalDataset/927_png.rf.ad4770eb0c90c1b9191f34340296a58d.jpg,427,718,306586,227880,78706
/media/gufran/GsHDD/Work/Projects/AI/PotholeSeverityClassification/Data/Step1_data/OriginalDataset/928_png.rf.dbd23690e39dcba87e8c906adfdeff8e.jpg,394,883,347902,255087,92815
/media/gufran/GsHDD/Work/Projects/AI/PotholeSeverityClassification/Data/Step1_data/OriginalDataset/929_png.rf.4430e3bd16d457f18f0b77c31fbe2862.jpg,310,872,270320,182108,88212
/media/gufran/GsHDD/Work/Projects/AI/PotholeSeverityClassification/Data/Step1_data/OriginalDataset/940_png.rf.7a383828aaa206226431718042000567.jpg,126,535,67410,52789,14621
/media/gufran/GsHDD/Work/Projects/AI/PotholeSeverityClassification/Data/Step1_data/OriginalDataset/942_png.rf.f18092306e1e99cca8901d4e5e6d5219.jpg,149,538,80162,63549,16613
/media/gufran/GsHDD/Work/Projects/AI/PotholeSeverityClassification/Data/Step1_data/OriginalDataset/942_png.rf.f18092306e1e99cca8901d4e5e6d5219.jpg,322,454,146188,109080,37108
/media/gufran/GsHDD/Work/Projects/AI/PotholeSeverityClassification/Data/Step1_data/OriginalDataset/943_png.rf.e794b2796d10f5899ee475b1f788a723.jpg,173,577,99821,72519,27302
/media/gufran/GsHDD/Work/Projects/AI/PotholeSeverityClassification/Data/Step1_data/OriginalDataset/943_png.rf.e794b2796d10f5899ee475b1f788a723.jpg,254,473,120142,91973,28169
/media/gufran/GsHDD/Work/Projects/AI/PotholeSeverityClassification/Data/Step1_data/OriginalDataset/944_png.rf.30410f22f49cd79bedc9b5e0703b8ecf.jpg,190,482,91580,74691,16889
/media/gufran/GsHDD/Work/Projects/AI/PotholeSeverityClassification/Data/Step1_data/OriginalDataset/944_png.rf.30410f22f49cd79bedc9b5e0703b8ecf.jpg,179,616,110264,83001,27263
/media/gufran/GsHDD/Work/Projects/AI/PotholeSeverityClassification/Data/Step1_data/OriginalDataset/946_png.rf.abbb72fa3e98616df1646adc4ead8334.jpg,224,706,158144,116360,41784
/media/gufran/GsHDD/Work/Projects/AI/PotholeSeverityClassification/Data/Step1_data/OriginalDataset/947_png.rf.d5d85e8a3fd4902582274fe0fe4ca2c8.jpg,272,754,205088,144031,61057
/media/gufran/GsHDD/Work/Projects/AI/PotholeSeverityClassification/Data/Step1_data/OriginalDataset/948_png.rf.c4d3698f21d2a5ec31514b83c3745880.jpg,277,847,234619,171908,62711
/media/gufran/GsHDD/Work/Projects/AI/PotholeSeverityClassification/Data/Step1_data/OriginalDataset/992_png.rf.a2d98bfe1aa8f0b7e0208dddefdc715a.jpg,153,481,73593,47514,26079
/media/gufran/GsHDD/Work/Projects/AI/PotholeSeverityClassification/Data/Step1_data/OriginalDataset/993_png.rf.63f993a6a727b9988ffd04da0f7756e4.jpg,177,514,90978,61867,29111
/media/gufran/GsHDD/Work/Projects/AI/PotholeSeverityClassification/Data/Step1_data/OriginalDataset/995_png.rf.d98695cd90a31cbce53be8bd7843cd08.jpg,225,559,125775,76209,49566
/media/gufran/GsHDD/Work/Projects/AI/PotholeSeverityClassification/Data/Step1_data/OriginalDataset/996_png.rf.84287add9d8d9815360c890c48027616.jpg,273,586,159978,92051,67927
/media/gufran/GsHDD/Work/Projects/AI/PotholeSeverityClassification/Data/Step1_data/OriginalDataset/997_png.rf.727aefddefe3c4e6af45bc2cebf8c85d.jpg,346,655,226630,125879,100751
/media/gufran/GsHDD/Work/Projects/AI/PotholeSeverityClassification/Data/Step1_data/OriginalDataset/998_png.rf.d971bfb663c11a22e37f4d238508bb00.jpg,376,694,260944,148884,112060
/media/gufran/GsHDD/Work/Projects/AI/PotholeSeverityClassification/Data/Step1_data/OriginalDataset/999_png.rf.ae67bda3c490ba679df576cbea256e9e.jpg,424,718,304432,169538,134894
