imgpath,height,width,area,pothole_area,nonpothole_area
/media/gufran/GsHDD/Work/Projects/AI/PotholeSeverityClassification/Data/Step1_data/OriginalDataset/458_png.rf.0b177d980d199bfc4af20479076a4693.jpg,58,226,13108,10094,3014
/media/gufran/GsHDD/Work/Projects/AI/PotholeSeverityClassification/Data/Step1_data/OriginalDataset/458_png.rf.0b177d980d199bfc4af20479076a4693.jpg,54,181,9774,8430,1344
/media/gufran/GsHDD/Work/Projects/AI/PotholeSeverityClassification/Data/Step1_data/OriginalDataset/600_png.rf.10df765e7f4560535cce7eacaf3d3253.jpg,61,109,6649,5011,1638
/media/gufran/GsHDD/Work/Projects/AI/PotholeSeverityClassification/Data/Step1_data/OriginalDataset/1004_png.rf.df29496350834f39a45fccdf520afc4b.jpg,94,88,8272,7056,1216
/media/gufran/GsHDD/Work/Projects/AI/PotholeSeverityClassification/Data/Step1_data/OriginalDataset/1005_png.rf.387999f45be31ce5eca6e0a1d4a910f0.jpg,236,280,66080,54981,11099
/media/gufran/GsHDD/Work/Projects/AI/PotholeSeverityClassification/Data/Step1_data/OriginalDataset/1005_png.rf.387999f45be31ce5eca6e0a1d4a910f0.jpg,70,164,11480,8345,3135
/media/gufran/GsHDD/Work/Projects/AI/PotholeSeverityClassification/Data/Step1_data/OriginalDataset/1006_png.rf.dec56d2fc9bb2f8e68a0237fe5339763.jpg,43,142,6106,4609,1497
/media/gufran/GsHDD/Work/Projects/AI/PotholeSeverityClassification/Data/Step1_data/OriginalDataset/100_png.rf.8b24d0221e213406b1c0fb47edf25eec.jpg,64,293,18752,13842,4910
/media/gufran/GsHDD/Work/Projects/AI/PotholeSeverityClassification/Data/Step1_data/OriginalDataset/1016_png.rf.31c6e4f0cae3f621144de75e6be34d57.jpg,227,295,66965,53366,13599
/media/gufran/GsHDD/Work/Projects/AI/PotholeSeverityClassification/Data/Step1_data/OriginalDataset/1016_png.rf.31c6e4f0cae3f621144de75e6be34d57.jpg,73,158,11534,8565,2969
/media/gufran/GsHDD/Work/Projects/AI/PotholeSeverityClassification/Data/Step1_data/OriginalDataset/1018_png.rf.d19c9f31fb789e5d9c0e9d93d5f55496.jpg,49,130,6370,4965,1405
/media/gufran/GsHDD/Work/Projects/AI/PotholeSeverityClassification/Data/Step1_data/OriginalDataset/1019_png.rf.f91432cc25f40b13bc62dc9ae522b7b4.jpg,58,130,7540,6172,1368
/media/gufran/GsHDD/Work/Projects/AI/PotholeSeverityClassification/Data/Step1_data/OriginalDataset/1020_png.rf.ed376092782e2d2784c66bc2f8f6b350.jpg,53,136,7208,5677,1531
/media/gufran/GsHDD/Work/Projects/AI/PotholeSeverityClassification/Data/Step1_data/OriginalDataset/1022_png.rf.0e3760d4e36294db5b8874875469960a.jpg,58,142,8236,6724,1512
/media/gufran/GsHDD/Work/Projects/AI/PotholeSeverityClassification/Data/Step1_data/OriginalDataset/1023_png.rf.eb566db924fe0592358ae7ac693a70db.jpg,68,151,10268,7738,2530
/media/gufran/GsHDD/Work/Projects/AI/PotholeSeverityClassification/Data/Step1_data/OriginalDataset/1024_png.rf.332f5dd2aa86b02e3349217d617ec731.jpg,70,157,10990,8294,2696
/media/gufran/GsHDD/Work/Projects/AI/PotholeSeverityClassification/Data/Step1_data/OriginalDataset/1025_png.rf.bd125a3d6afbcf8a780f738fb469419c.jpg,79,163,12877,9149,3728
/media/gufran/GsHDD/Work/Projects/AI/PotholeSeverityClassification/Data/Step1_data/OriginalDataset/1026_png.rf.cd13496201abb956d546db0039cf61be.jpg,211,306,64566,51167,13399
/media/gufran/GsHDD/Work/Projects/AI/PotholeSeverityClassification/Data/Step1_data/OriginalDataset/1026_png.rf.cd13496201abb956d546db0039cf61be.jpg,74,121,8954,7428,1526
/media/gufran/GsHDD/Work/Projects/AI/PotholeSeverityClassification/Data/Step1_data/OriginalDataset/1027_png.rf.a78f4da89a6bf356a8855ccc4ae73cd0.jpg,88,172,15136,10451,4685
/media/gufran/GsHDD/Work/Projects/AI/PotholeSeverityClassification/Data/Step1_data/OriginalDataset/1028_png.rf.7ae4a7b5fc46bbc6d0c3dd1fe10e3a3c.jpg,91,181,16471,11344,5127
/media/gufran/GsHDD/Work/Projects/AI/PotholeSeverityClassification/Data/Step1_data/OriginalDataset/1029_png.rf.a704a6de9321e520f640240e78cbea02.jpg,97,187,18139,12991,5148
/media/gufran/GsHDD/Work/Projects/AI/PotholeSeverityClassification/Data/Step1_data/OriginalDataset/102_png.rf.6b89cce218f681f6077465a57a7b54cb.jpg,49,190,9310,5947,3363
/media/gufran/GsHDD/Work/Projects/AI/PotholeSeverityClassification/Data/Step1_data/OriginalDataset/1030_png.rf.ccf5aead783cba4260c542ad876038cb.jpg,109,199,21691,15293,6398
/media/gufran/GsHDD/Work/Projects/AI/PotholeSeverityClassification/Data/Step1_data/OriginalDataset/1031_png.rf.45449b433856f3b923b525c074701383.jpg,95,208,19760,15429,4331
/media/gufran/GsHDD/Work/Projects/AI/PotholeSeverityClassification/Data/Step1_data/OriginalDataset/1033_png.rf.b0948b36738e35b8e4fb02b5dbe073f0.jpg,37,185,6845,4653,2192
/media/gufran/GsHDD/Work/Projects/AI/PotholeSeverityClassification/Data/Step1_data/OriginalDataset/1047_png.rf.55cd9413c74b40349a657b483cea1fef.jpg,184,331,60904,45275,15629
/media/gufran/GsHDD/Work/Projects/AI/PotholeSeverityClassification/Data/Step1_data/OriginalDataset/104_png.rf.6d7f954978632ead83d4b0ff31aa813b.jpg,99,211,20889,12022,8867
/media/gufran/GsHDD/Work/Projects/AI/PotholeSeverityClassification/Data/Step1_data/OriginalDataset/1060_png.rf.ac108148e41aa5962449ca3d533b4e7b.jpg,88,151,13288,9972,3316
/media/gufran/GsHDD/Work/Projects/AI/PotholeSeverityClassification/Data/Step1_data/OriginalDataset/1061_png.rf.da772af259c5ea0543609b09e8923b54.jpg,65,238,15470,9713,5757
/media/gufran/GsHDD/Work/Projects/AI/PotholeSeverityClassification/Data/Step1_data/OriginalDataset/1021_png.rf.f33c82ae3da761cbf4ed757b456b959b.jpg,61,142,8662,6735,1927
/media/gufran/GsHDD/Work/Projects/AI/PotholeSeverityClassification/Data/Step1_data/OriginalDataset/1032_png.rf.4f3f77ff9edeef338e02f76fdf8bb59e.jpg,64,220,14080,11067,3013
/media/gufran/GsHDD/Work/Projects/AI/PotholeSeverityClassification/Data/Step1_data/OriginalDataset/1079_png.rf.4345c357d5c774ec05c31f3a6126d8a7.jpg,133,418,55594,35193,20401
/media/gufran/GsHDD/Work/Projects/AI/PotholeSeverityClassification/Data/Step1_data/OriginalDataset/1161_png.rf.589652afb39d46e50d8b93582c417d59.jpg,76,175,13300,9937,3363
/media/gufran/GsHDD/Work/Projects/AI/PotholeSeverityClassification/Data/Step1_data/OriginalDataset/158_png.rf.860a50ff39ffd5840928ecfc67a72415.jpg,56,211,11816,9731,2085
/media/gufran/GsHDD/Work/Projects/AI/PotholeSeverityClassification/Data/Step1_data/OriginalDataset/1080_png.rf.4e5e0e82236c4c5bcf1984821f9bb4be.jpg,121,401,48521,29823,18698
/media/gufran/GsHDD/Work/Projects/AI/PotholeSeverityClassification/Data/Step1_data/OriginalDataset/1081_png.rf.01c5eb617df2efef67103a025550ecfa.jpg,109,368,40112,23692,16420
/media/gufran/GsHDD/Work/Projects/AI/PotholeSeverityClassification/Data/Step1_data/OriginalDataset/1082_png.rf.fe6ca3872128e1442bf3e2babf9e56da.jpg,94,308,28952,17964,10988
/media/gufran/GsHDD/Work/Projects/AI/PotholeSeverityClassification/Data/Step1_data/OriginalDataset/1083_png.rf.02da0db6deadd9ea9e53cffd2bfe7351.jpg,73,257,18761,12117,6644
/media/gufran/GsHDD/Work/Projects/AI/PotholeSeverityClassification/Data/Step1_data/OriginalDataset/10_png.rf.406d74a50d9e84a2b9aeb7c716222c90.jpg,98,277,27146,19337,7809
/media/gufran/GsHDD/Work/Projects/AI/PotholeSeverityClassification/Data/Step1_data/OriginalDataset/1106_png.rf.420fcce8533bd03a550e3700922b95e3.jpg,58,109,6322,4943,1379
/media/gufran/GsHDD/Work/Projects/AI/PotholeSeverityClassification/Data/Step1_data/OriginalDataset/1142_png.rf.5ba42c154750b386b45ca474cb64d52a.jpg,241,685,165085,113412,51673
/media/gufran/GsHDD/Work/Projects/AI/PotholeSeverityClassification/Data/Step1_data/OriginalDataset/1160_png.rf.a4af62354f92bfe4aa2f67eb5b66fd02.jpg,64,148,9472,6982,2490
/media/gufran/GsHDD/Work/Projects/AI/PotholeSeverityClassification/Data/Step1_data/OriginalDataset/1162_png.rf.753c48f7060d28635cfcf4cf1a266ee0.jpg,70,208,14560,10373,4187
/media/gufran/GsHDD/Work/Projects/AI/PotholeSeverityClassification/Data/Step1_data/OriginalDataset/117_png.rf.77c7ef0249f1d8db10f5fa5f18af017f.jpg,166,322,53452,36701,16751
/media/gufran/GsHDD/Work/Projects/AI/PotholeSeverityClassification/Data/Step1_data/OriginalDataset/118_png.rf.8f9fc1589ff797852cc1b6230ec8dfad.jpg,128,382,48896,36719,12177
/media/gufran/GsHDD/Work/Projects/AI/PotholeSeverityClassification/Data/Step1_data/OriginalDataset/121_png.rf.a77245a0a16bb01e886e394a7e570839.jpg,58,320,18560,13358,5202
/media/gufran/GsHDD/Work/Projects/AI/PotholeSeverityClassification/Data/Step1_data/OriginalDataset/124_png.rf.63cbbbf44565410970643d06f342a02a.jpg,175,379,66325,42434,23891
/media/gufran/GsHDD/Work/Projects/AI/PotholeSeverityClassification/Data/Step1_data/OriginalDataset/126_png.rf.a0881750555c2395950448ab72a6d101.jpg,193,115,22195,15764,6431
/media/gufran/GsHDD/Work/Projects/AI/PotholeSeverityClassification/Data/Step1_data/OriginalDataset/128_png.rf.91cb63fdde3123140b5a565df8357d1e.jpg,136,332,45152,32725,12427
/media/gufran/GsHDD/Work/Projects/AI/PotholeSeverityClassification/Data/Step1_data/OriginalDataset/1364_png.rf.a8e5ad8dc67495fd0ec99df3d33d42fa.jpg,59,322,18998,15208,3790
/media/gufran/GsHDD/Work/Projects/AI/PotholeSeverityClassification/Data/Step1_data/OriginalDataset/1375_png.rf.20aea68fcde2e303887c2faaad4f40b5.jpg,56,346,19376,15757,3619
/media/gufran/GsHDD/Work/Projects/AI/PotholeSeverityClassification/Data/Step1_data/OriginalDataset/137_png.rf.ac481da94dbc4407fd63d506d7781161.jpg,73,244,17812,14733,3079
/media/gufran/GsHDD/Work/Projects/AI/PotholeSeverityClassification/Data/Step1_data/OriginalDataset/140_png.rf.9861ef0b73b35d053d8852c3a6ac8c87.jpg,76,277,21052,16998,4054
/media/gufran/GsHDD/Work/Projects/AI/PotholeSeverityClassification/Data/Step1_data/OriginalDataset/147_png.rf.bb0fff7dcd4a09048c30088f2f3dd8bd.jpg,65,359,23335,19842,3493
/media/gufran/GsHDD/Work/Projects/AI/PotholeSeverityClassification/Data/Step1_data/OriginalDataset/159_png.rf.87833ca4613fd509c9bf6c7734aaa472.jpg,61,223,13603,11010,2593
/media/gufran/GsHDD/Work/Projects/AI/PotholeSeverityClassification/Data/Step1_data/OriginalDataset/160_png.rf.3fdafa712989a0f12903e73e7ffa5f0b.jpg,56,232,12992,10692,2300
/media/gufran/GsHDD/Work/Projects/AI/PotholeSeverityClassification/Data/Step1_data/OriginalDataset/161_png.rf.e7595d143fe26f1b9dbc403a7421f7c9.jpg,62,244,15128,12116,3012
/media/gufran/GsHDD/Work/Projects/AI/PotholeSeverityClassification/Data/Step1_data/OriginalDataset/162_png.rf.a073c9a103739e1a6d9974526f3cac53.jpg,65,256,16640,13944,2696
/media/gufran/GsHDD/Work/Projects/AI/PotholeSeverityClassification/Data/Step1_data/OriginalDataset/163_png.rf.fc10135509524d00531d03d1d2cab7dc.jpg,71,268,19028,15591,3437
/media/gufran/GsHDD/Work/Projects/AI/PotholeSeverityClassification/Data/Step1_data/OriginalDataset/165_png.rf.b34b776463c5c3580b605b191efc85e7.jpg,80,286,22880,18363,4517
/media/gufran/GsHDD/Work/Projects/AI/PotholeSeverityClassification/Data/Step1_data/OriginalDataset/166_png.rf.895221b0554cd329f7be27285fdf514d.jpg,80,304,24320,20185,4135
/media/gufran/GsHDD/Work/Projects/AI/PotholeSeverityClassification/Data/Step1_data/OriginalDataset/167_png.rf.ea00e86dbfc10da9125625b9c5cd5af0.jpg,76,319,24244,20674,3570
/media/gufran/GsHDD/Work/Projects/AI/PotholeSeverityClassification/Data/Step1_data/OriginalDataset/174_png.rf.a80b0ffb72da84bf5207f2c0518e07bf.jpg,114,235,26790,18081,8709
/media/gufran/GsHDD/Work/Projects/AI/PotholeSeverityClassification/Data/Step1_data/OriginalDataset/185_png.rf.b5339b18a8d85aeb1b64524329315969.jpg,147,268,39396,26190,13206
/media/gufran/GsHDD/Work/Projects/AI/PotholeSeverityClassification/Data/Step1_data/OriginalDataset/18_png.rf.32f45ef2d9c43648e5a3ceda1ca20aa0.jpg,149,358,53342,37827,15515
/media/gufran/GsHDD/Work/Projects/AI/PotholeSeverityClassification/Data/Step1_data/OriginalDataset/195_png.rf.3f234db7015c99ba43aa70ef5db2be73.jpg,63,98,6174,5056,1118
/media/gufran/GsHDD/Work/Projects/AI/PotholeSeverityClassification/Data/Step1_data/OriginalDataset/196_png.rf.f4ac1dcc531b6d7fd7a2d218990378db.jpg,189,304,57456,33234,24222
/media/gufran/GsHDD/Work/Projects/AI/PotholeSeverityClassification/Data/Step1_data/OriginalDataset/207_png.rf.01e9f6932474887a004118037ef55eb6.jpg,208,319,66352,37035,29317
/media/gufran/GsHDD/Work/Projects/AI/PotholeSeverityClassification/Data/Step1_data/OriginalDataset/20_png.rf.c3e46cf2581bf2af3e20c5cd17065a30.jpg,130,364,47320,35667,11653
/media/gufran/GsHDD/Work/Projects/AI/PotholeSeverityClassification/Data/Step1_data/OriginalDataset/217_png.rf.8a0cf758585006af69d39f8afa484bc4.jpg,211,358,75538,46615,28923
/media/gufran/GsHDD/Work/Projects/AI/PotholeSeverityClassification/Data/Step1_data/OriginalDataset/219_png.rf.6e8f147ec7968f76a22f66bb37e75b9f.jpg,127,439,55753,37915,17838
/media/gufran/GsHDD/Work/Projects/AI/PotholeSeverityClassification/Data/Step1_data/OriginalDataset/220_png.rf.e14c3210f6eb8a3d68120cdfa90ab9d4.jpg,133,436,57988,38882,19106
/media/gufran/GsHDD/Work/Projects/AI/PotholeSeverityClassification/Data/Step1_data/OriginalDataset/220_png.rf.e14c3210f6eb8a3d68120cdfa90ab9d4.jpg,67,172,11524,8007,3517
/media/gufran/GsHDD/Work/Projects/AI/PotholeSeverityClassification/Data/Step1_data/OriginalDataset/221_png.rf.fec18983d34af2b43b56b5608593645d.jpg,73,181,13213,9296,3917
/media/gufran/GsHDD/Work/Projects/AI/PotholeSeverityClassification/Data/Step1_data/OriginalDataset/222_png.rf.03577c3105db70f5006b3794b123a0aa.jpg,67,172,11524,8483,3041
/media/gufran/GsHDD/Work/Projects/AI/PotholeSeverityClassification/Data/Step1_data/OriginalDataset/224_png.rf.61b918aad4e6fde9971653fddbdaa15c.jpg,79,178,14062,9941,4121
/media/gufran/GsHDD/Work/Projects/AI/PotholeSeverityClassification/Data/Step1_data/OriginalDataset/225_png.rf.2f07ba8566ffff5d0370f516ce2dd902.jpg,86,205,17630,12464,5166
/media/gufran/GsHDD/Work/Projects/AI/PotholeSeverityClassification/Data/Step1_data/OriginalDataset/226_png.rf.b635d13eaa2341c461bc7414db677cd3.jpg,79,202,15958,11425,4533
/media/gufran/GsHDD/Work/Projects/AI/PotholeSeverityClassification/Data/Step1_data/OriginalDataset/227_png.rf.165486971fc7ccbfc523aea289723c06.jpg,85,196,16660,12713,3947
/media/gufran/GsHDD/Work/Projects/AI/PotholeSeverityClassification/Data/Step1_data/OriginalDataset/228_png.rf.9e22fbae97220927f302421730588125.jpg,88,223,19624,14178,5446
/media/gufran/GsHDD/Work/Projects/AI/PotholeSeverityClassification/Data/Step1_data/OriginalDataset/23_png.rf.434635c98a4f05ceae1ae0f93626bfa8.jpg,87,100,8700,7384,1316
/media/gufran/GsHDD/Work/Projects/AI/PotholeSeverityClassification/Data/Step1_data/OriginalDataset/245_png.rf.eabcb38d4bf8c61042a72da6ef83b1c6.jpg,67,235,15745,12696,3049
/media/gufran/GsHDD/Work/Projects/AI/PotholeSeverityClassification/Data/Step1_data/OriginalDataset/246_png.rf.be90ba925edb5d69786f6b6b34feb099.jpg,64,244,15616,12908,2708
/media/gufran/GsHDD/Work/Projects/AI/PotholeSeverityClassification/Data/Step1_data/OriginalDataset/247_png.rf.efed291d5ca5cd6c70e3b5ed1eafd84f.jpg,68,265,18020,14597,3423
/media/gufran/GsHDD/Work/Projects/AI/PotholeSeverityClassification/Data/Step1_data/OriginalDataset/248_png.rf.9710e88f31857c4a7a15dfc4773ee6c9.jpg,80,277,22160,18064,4096
/media/gufran/GsHDD/Work/Projects/AI/PotholeSeverityClassification/Data/Step1_data/OriginalDataset/250_png.rf.64228383242a394ef2c8c7d53df390d6.jpg,95,304,28880,22826,6054
/media/gufran/GsHDD/Work/Projects/AI/PotholeSeverityClassification/Data/Step1_data/OriginalDataset/252_png.rf.c24a6ed0b5456af05a9470bb69c2c071.jpg,85,352,29920,24238,5682
/media/gufran/GsHDD/Work/Projects/AI/PotholeSeverityClassification/Data/Step1_data/OriginalDataset/281_png.rf.54450cdf2f8c1d55aa7c80f7b70a570e.jpg,94,310,29140,23335,5805
/media/gufran/GsHDD/Work/Projects/AI/PotholeSeverityClassification/Data/Step1_data/OriginalDataset/284_png.rf.cf83292fe0587909ce0ad3ecd80322c0.jpg,159,346,55014,41118,13896
/media/gufran/GsHDD/Work/Projects/AI/PotholeSeverityClassification/Data/Step1_data/OriginalDataset/286_png.rf.a52f69106c2020e48f11e5b6c226cc8f.jpg,232,409,94888,70689,24199
/media/gufran/GsHDD/Work/Projects/AI/PotholeSeverityClassification/Data/Step1_data/OriginalDataset/286_png.rf.a52f69106c2020e48f11e5b6c226cc8f.jpg,79,148,11692,6444,5248
/media/gufran/GsHDD/Work/Projects/AI/PotholeSeverityClassification/Data/Step1_data/OriginalDataset/286_png.rf.a52f69106c2020e48f11e5b6c226cc8f.jpg,128,115,14720,12605,2115
/media/gufran/GsHDD/Work/Projects/AI/PotholeSeverityClassification/Data/Step1_data/OriginalDataset/287_png.rf.c341eaa28663b375a88eebae7832344c.jpg,223,514,114622,73271,41351
/media/gufran/GsHDD/Work/Projects/AI/PotholeSeverityClassification/Data/Step1_data/OriginalDataset/287_png.rf.c341eaa28663b375a88eebae7832344c.jpg,118,172,20296,9804,10492
/media/gufran/GsHDD/Work/Projects/AI/PotholeSeverityClassification/Data/Step1_data/OriginalDataset/306_png.rf.2e89596e1567479d7d73f362ddc0b6ef.jpg,61,298,18178,13502,4676
/media/gufran/GsHDD/Work/Projects/AI/PotholeSeverityClassification/Data/Step1_data/OriginalDataset/307_png.rf.22adfc2125b795d6b3d454ce66dc8832.jpg,77,343,26411,14218,12193
/media/gufran/GsHDD/Work/Projects/AI/PotholeSeverityClassification/Data/Step1_data/OriginalDataset/308_png.rf.32921c073ff82ec9d00191d00463d514.jpg,94,394,37036,18407,18629
/media/gufran/GsHDD/Work/Projects/AI/PotholeSeverityClassification/Data/Step1_data/OriginalDataset/30_png.rf.8ed476e993aed088e75b567573f07293.jpg,60,140,8400,5925,2475
/media/gufran/GsHDD/Work/Projects/AI/PotholeSeverityClassification/Data/Step1_data/OriginalDataset/31_png.rf.f63040dcef0f14e5ce2144af63f44e78.jpg,99,163,16137,11450,4687
/media/gufran/GsHDD/Work/Projects/AI/PotholeSeverityClassification/Data/Step1_data/OriginalDataset/32_png.rf.cc95123c038c354a1fd78cce35ea28a9.jpg,133,181,24073,16863,7210
/media/gufran/GsHDD/Work/Projects/AI/PotholeSeverityClassification/Data/Step1_data/OriginalDataset/33_png.rf.6ab76c7bc791fb8ac0ac0cb9285d340c.jpg,151,202,30502,20530,9972
/media/gufran/GsHDD/Work/Projects/AI/PotholeSeverityClassification/Data/Step1_data/OriginalDataset/35_png.rf.ab7519813f4409aab675faceb7af3a5b.jpg,184,214,39376,25699,13677
/media/gufran/GsHDD/Work/Projects/AI/PotholeSeverityClassification/Data/Step1_data/OriginalDataset/36_png.rf.ead60a1b73a762d527f3a77aa173ae6d.jpg,160,238,38080,26099,11981
/media/gufran/GsHDD/Work/Projects/AI/PotholeSeverityClassification/Data/Step1_data/OriginalDataset/380_png.rf.59e6e94446a94aecd05de5086b427575.jpg,139,523,72697,56245,16452
/media/gufran/GsHDD/Work/Projects/AI/PotholeSeverityClassification/Data/Step1_data/OriginalDataset/381_png.rf.ee1ad465ef3e06bf641f8c6206881938.jpg,142,520,73840,58490,15350
/media/gufran/GsHDD/Work/Projects/AI/PotholeSeverityClassification/Data/Step1_data/OriginalDataset/392_png.rf.66f78c785244100aac57ee98ff35078e.jpg,36,101,3636,2658,978
/media/gufran/GsHDD/Work/Projects/AI/PotholeSeverityClassification/Data/Step1_data/OriginalDataset/394_png.rf.ade5b4d69033d4c4abbc5c5ec48f8974.jpg,53,115,6095,4442,1653
/media/gufran/GsHDD/Work/Projects/AI/PotholeSeverityClassification/Data/Step1_data/OriginalDataset/394_png.rf.ade5b4d69033d4c4abbc5c5ec48f8974.jpg,49,124,6076,4944,1132
/media/gufran/GsHDD/Work/Projects/AI/PotholeSeverityClassification/Data/Step1_data/OriginalDataset/396_png.rf.a074a9bf0f17c700ee5a38e2bc489913.jpg,67,349,23383,20086,3297
/media/gufran/GsHDD/Work/Projects/AI/PotholeSeverityClassification/Data/Step1_data/OriginalDataset/397_png.rf.107e6c053669eef3127e10940e32861f.jpg,70,364,25480,22461,3019
/media/gufran/GsHDD/Work/Projects/AI/PotholeSeverityClassification/Data/Step1_data/OriginalDataset/398_png.rf.b2487c7c68b8cb2956e60a366da93b31.jpg,82,385,31570,26410,5160
/media/gufran/GsHDD/Work/Projects/AI/PotholeSeverityClassification/Data/Step1_data/OriginalDataset/399_png.rf.a34acd94f1e99751ea397bbca9f5cd78.jpg,91,412,37492,33313,4179
/media/gufran/GsHDD/Work/Projects/AI/PotholeSeverityClassification/Data/Step1_data/OriginalDataset/400_png.rf.3b6691f5f398bba33a12d1ff525703b6.jpg,106,430,45580,40537,5043
/media/gufran/GsHDD/Work/Projects/AI/PotholeSeverityClassification/Data/Step1_data/OriginalDataset/401_png.rf.d4e823aa995ad937ea71e9ab288239fc.jpg,109,472,51448,45614,5834
/media/gufran/GsHDD/Work/Projects/AI/PotholeSeverityClassification/Data/Step1_data/OriginalDataset/428_png.rf.64fe5ea88edb8fd7c278c7a5ee572e28.jpg,115,343,39445,32019,7426
/media/gufran/GsHDD/Work/Projects/AI/PotholeSeverityClassification/Data/Step1_data/OriginalDataset/429_png.rf.34accd4da1d744a210ad875d9b0726d4.jpg,94,334,31396,26308,5088
/media/gufran/GsHDD/Work/Projects/AI/PotholeSeverityClassification/Data/Step1_data/OriginalDataset/43_png.rf.acdf286fb20178c479e11adaebd1d944.jpg,115,205,23575,16980,6595
/media/gufran/GsHDD/Work/Projects/AI/PotholeSeverityClassification/Data/Step1_data/OriginalDataset/44_png.rf.c2727527e246d3acc4e0e6363f1714c1.jpg,118,115,13570,11262,2308
/media/gufran/GsHDD/Work/Projects/AI/PotholeSeverityClassification/Data/Step1_data/OriginalDataset/457_png.rf.3466587f333ef4a2f257b2636494e89f.jpg,52,178,9256,7414,1842
/media/gufran/GsHDD/Work/Projects/AI/PotholeSeverityClassification/Data/Step1_data/OriginalDataset/457_png.rf.3466587f333ef4a2f257b2636494e89f.jpg,54,214,11556,9104,2452
/media/gufran/GsHDD/Work/Projects/AI/PotholeSeverityClassification/Data/Step1_data/OriginalDataset/459_png.rf.fe4434d806a4ff5f8fec357cdcb0ab21.jpg,61,229,13969,10972,2997
/media/gufran/GsHDD/Work/Projects/AI/PotholeSeverityClassification/Data/Step1_data/OriginalDataset/459_png.rf.fe4434d806a4ff5f8fec357cdcb0ab21.jpg,57,181,10317,9049,1268
/media/gufran/GsHDD/Work/Projects/AI/PotholeSeverityClassification/Data/Step1_data/OriginalDataset/45_png.rf.e821286af06dd1521c96347f28be8381.jpg,145,238,34510,24280,10230
/media/gufran/GsHDD/Work/Projects/AI/PotholeSeverityClassification/Data/Step1_data/OriginalDataset/460_png.rf.20ae3d0b5b4f9ebf908dc5f3a2e957f7.jpg,58,184,10672,9285,1387
/media/gufran/GsHDD/Work/Projects/AI/PotholeSeverityClassification/Data/Step1_data/OriginalDataset/460_png.rf.20ae3d0b5b4f9ebf908dc5f3a2e957f7.jpg,64,235,15040,11574,3466
/media/gufran/GsHDD/Work/Projects/AI/PotholeSeverityClassification/Data/Step1_data/OriginalDataset/461_png.rf.f06107e41d4c08711027f4675691368b.jpg,64,187,11968,10327,1641
/media/gufran/GsHDD/Work/Projects/AI/PotholeSeverityClassification/Data/Step1_data/OriginalDataset/461_png.rf.f06107e41d4c08711027f4675691368b.jpg,70,235,16450,12730,3720
/media/gufran/GsHDD/Work/Projects/AI/PotholeSeverityClassification/Data/Step1_data/OriginalDataset/462_png.rf.e9fc28866d7822429a4d9beabb78a983.jpg,77,244,18788,14038,4750
/media/gufran/GsHDD/Work/Projects/AI/PotholeSeverityClassification/Data/Step1_data/OriginalDataset/462_png.rf.e9fc28866d7822429a4d9beabb78a983.jpg,73,193,14089,11766,2323
/media/gufran/GsHDD/Work/Projects/AI/PotholeSeverityClassification/Data/Step1_data/OriginalDataset/46_png.rf.b428a0978fd521481925b2f8a6cfcb60.jpg,121,256,30976,23171,7805
/media/gufran/GsHDD/Work/Projects/AI/PotholeSeverityClassification/Data/Step1_data/OriginalDataset/46_png.rf.b428a0978fd521481925b2f8a6cfcb60.jpg,49,122,5978,4250,1728
/media/gufran/GsHDD/Work/Projects/AI/PotholeSeverityClassification/Data/Step1_data/OriginalDataset/223_png.rf.b467126a3c13a6d1ffa27e6bb0f07c75.jpg,85,184,15640,10652,4988
/media/gufran/GsHDD/Work/Projects/AI/PotholeSeverityClassification/Data/Step1_data/OriginalDataset/251_png.rf.817737c2925de8227cefe56021b64a77.jpg,94,325,30550,24896,5654
/media/gufran/GsHDD/Work/Projects/AI/PotholeSeverityClassification/Data/Step1_data/OriginalDataset/288_png.rf.01e11c64c53d463d858b6029d49badd8.jpg,193,524,101132,65850,35282
/media/gufran/GsHDD/Work/Projects/AI/PotholeSeverityClassification/Data/Step1_data/OriginalDataset/395_png.rf.497973ed6fc0076c2eea45271b137dea.jpg,52,130,6760,5464,1296
/media/gufran/GsHDD/Work/Projects/AI/PotholeSeverityClassification/Data/Step1_data/OriginalDataset/395_png.rf.497973ed6fc0076c2eea45271b137dea.jpg,58,293,16994,11328,5666
/media/gufran/GsHDD/Work/Projects/AI/PotholeSeverityClassification/Data/Step1_data/OriginalDataset/395_png.rf.497973ed6fc0076c2eea45271b137dea.jpg,44,76,3344,2476,868
/media/gufran/GsHDD/Work/Projects/AI/PotholeSeverityClassification/Data/Step1_data/OriginalDataset/436_png.rf.b23c676f36f73a7f326b8c0d2a55ad37.jpg,109,88,9592,7992,1600
/media/gufran/GsHDD/Work/Projects/AI/PotholeSeverityClassification/Data/Step1_data/OriginalDataset/436_png.rf.b23c676f36f73a7f326b8c0d2a55ad37.jpg,65,218,14170,10942,3228
/media/gufran/GsHDD/Work/Projects/AI/PotholeSeverityClassification/Data/Step1_data/OriginalDataset/484_png.rf.d56e8e0aa21fe6025bcf505762126596.jpg,51,247,12597,8295,4302
/media/gufran/GsHDD/Work/Projects/AI/PotholeSeverityClassification/Data/Step1_data/OriginalDataset/485_png.rf.2fd7fd2cca8a21ac03c7184c75b96239.jpg,57,256,14592,10084,4508
/media/gufran/GsHDD/Work/Projects/AI/PotholeSeverityClassification/Data/Step1_data/OriginalDataset/486_png.rf.8bcd0e4c86af983a3d759453ce4f1a53.jpg,69,262,18078,11453,6625
/media/gufran/GsHDD/Work/Projects/AI/PotholeSeverityClassification/Data/Step1_data/OriginalDataset/487_png.rf.a9bc039aa9f604ba2d3e19b4df6132de.jpg,84,274,23016,13658,9358
/media/gufran/GsHDD/Work/Projects/AI/PotholeSeverityClassification/Data/Step1_data/OriginalDataset/488_png.rf.db2436ef991a2de6ff60d803f3b27d64.jpg,87,280,24360,14334,10026
/media/gufran/GsHDD/Work/Projects/AI/PotholeSeverityClassification/Data/Step1_data/OriginalDataset/48_png.rf.3e70278eb0585436d49cfeaf711ec8f9.jpg,117,202,23634,17398,6236
/media/gufran/GsHDD/Work/Projects/AI/PotholeSeverityClassification/Data/Step1_data/OriginalDataset/48_png.rf.3e70278eb0585436d49cfeaf711ec8f9.jpg,94,163,15322,10565,4757
/media/gufran/GsHDD/Work/Projects/AI/PotholeSeverityClassification/Data/Step1_data/OriginalDataset/490_png.rf.08856e71f4d1bdc8b2aee0845e515fe5.jpg,100,301,30100,17943,12157
/media/gufran/GsHDD/Work/Projects/AI/PotholeSeverityClassification/Data/Step1_data/OriginalDataset/491_png.rf.346585ecd63903b4ea145bd0ead1709c.jpg,103,307,31621,19069,12552
/media/gufran/GsHDD/Work/Projects/AI/PotholeSeverityClassification/Data/Step1_data/OriginalDataset/492_png.rf.9081414c6bf4ffbec311f1fe41913828.jpg,109,319,34771,20450,14321
/media/gufran/GsHDD/Work/Projects/AI/PotholeSeverityClassification/Data/Step1_data/OriginalDataset/494_png.rf.58f3029e96bdaf9193f1bd0683889727.jpg,115,325,37375,22063,15312
/media/gufran/GsHDD/Work/Projects/AI/PotholeSeverityClassification/Data/Step1_data/OriginalDataset/495_png.rf.0e55a450e75ab630af6b823be2535a3e.jpg,118,331,39058,23381,15677
/media/gufran/GsHDD/Work/Projects/AI/PotholeSeverityClassification/Data/Step1_data/OriginalDataset/496_png.rf.c8cf73f67b77bdde6b41fabbef308ee6.jpg,121,334,40414,24465,15949
/media/gufran/GsHDD/Work/Projects/AI/PotholeSeverityClassification/Data/Step1_data/OriginalDataset/497_png.rf.eef06ebea1a571f1c61c8cfdd057510c.jpg,130,346,44980,27040,17940
/media/gufran/GsHDD/Work/Projects/AI/PotholeSeverityClassification/Data/Step1_data/OriginalDataset/498_png.rf.789366bdf21afc13e6cde81e02d8f48d.jpg,136,358,48688,29398,19290
/media/gufran/GsHDD/Work/Projects/AI/PotholeSeverityClassification/Data/Step1_data/OriginalDataset/499_png.rf.32af7d7943b7261a754d0d5230474baa.jpg,142,373,52966,31512,21454
/media/gufran/GsHDD/Work/Projects/AI/PotholeSeverityClassification/Data/Step1_data/OriginalDataset/500_png.rf.8d4068939f209018249fa5b17eefff3b.jpg,139,376,52264,32301,19963
/media/gufran/GsHDD/Work/Projects/AI/PotholeSeverityClassification/Data/Step1_data/OriginalDataset/501_png.rf.8284e20e204c72fb9602da4640591639.jpg,154,394,60676,36331,24345
/media/gufran/GsHDD/Work/Projects/AI/PotholeSeverityClassification/Data/Step1_data/OriginalDataset/502_png.rf.77f77ea4d8f865937e8b2defd0427023.jpg,142,406,57652,36366,21286
/media/gufran/GsHDD/Work/Projects/AI/PotholeSeverityClassification/Data/Step1_data/OriginalDataset/505_png.rf.f2fcc242b0d43603be58fba57479d74a.jpg,53,139,7367,6021,1346
/media/gufran/GsHDD/Work/Projects/AI/PotholeSeverityClassification/Data/Step1_data/OriginalDataset/506_png.rf.6c445414db9586628ab53d02757918a5.jpg,98,109,10682,9119,1563
/media/gufran/GsHDD/Work/Projects/AI/PotholeSeverityClassification/Data/Step1_data/OriginalDataset/508_png.rf.7ef32d11bae9f86bf935b5152b7a5a73.jpg,61,157,9577,7477,2100
/media/gufran/GsHDD/Work/Projects/AI/PotholeSeverityClassification/Data/Step1_data/OriginalDataset/509_png.rf.dc37c755f3f372ec6eab2eae1b12284e.jpg,58,154,8932,7436,1496
/media/gufran/GsHDD/Work/Projects/AI/PotholeSeverityClassification/Data/Step1_data/OriginalDataset/50_png.rf.7dfac924764219a204188927a2ba983c.jpg,166,340,56440,27118,29322
/media/gufran/GsHDD/Work/Projects/AI/PotholeSeverityClassification/Data/Step1_data/OriginalDataset/50_png.rf.7dfac924764219a204188927a2ba983c.jpg,196,262,51352,35320,16032
/media/gufran/GsHDD/Work/Projects/AI/PotholeSeverityClassification/Data/Step1_data/OriginalDataset/517_png.rf.2c174eebb6160a44cc0a05dfccf6b33b.jpg,97,88,8536,7372,1164
/media/gufran/GsHDD/Work/Projects/AI/PotholeSeverityClassification/Data/Step1_data/OriginalDataset/51_png.rf.3d79e0c526005fbcf8132c855e87f482.jpg,127,259,32893,21158,11735
/media/gufran/GsHDD/Work/Projects/AI/PotholeSeverityClassification/Data/Step1_data/OriginalDataset/51_png.rf.3d79e0c526005fbcf8132c855e87f482.jpg,211,283,59713,44004,15709
/media/gufran/GsHDD/Work/Projects/AI/PotholeSeverityClassification/Data/Step1_data/OriginalDataset/51_png.rf.3d79e0c526005fbcf8132c855e87f482.jpg,109,217,23653,15742,7911
/media/gufran/GsHDD/Work/Projects/AI/PotholeSeverityClassification/Data/Step1_data/OriginalDataset/52_png.rf.ed7a55d059351b70dacd086f8aeb9d17.jpg,79,244,19276,13111,6165
/media/gufran/GsHDD/Work/Projects/AI/PotholeSeverityClassification/Data/Step1_data/OriginalDataset/52_png.rf.ed7a55d059351b70dacd086f8aeb9d17.jpg,145,247,35815,23989,11826
/media/gufran/GsHDD/Work/Projects/AI/PotholeSeverityClassification/Data/Step1_data/OriginalDataset/530_png.rf.59aeb0ae1cff6737713c56c5f7210be6.jpg,181,505,91405,74044,17361
/media/gufran/GsHDD/Work/Projects/AI/PotholeSeverityClassification/Data/Step1_data/OriginalDataset/532_png.rf.a2f0d7fa800e10e8c2abc1066ea6003b.jpg,73,196,14308,11986,2322
/media/gufran/GsHDD/Work/Projects/AI/PotholeSeverityClassification/Data/Step1_data/OriginalDataset/532_png.rf.a2f0d7fa800e10e8c2abc1066ea6003b.jpg,83,244,20252,14619,5633
/media/gufran/GsHDD/Work/Projects/AI/PotholeSeverityClassification/Data/Step1_data/OriginalDataset/533_png.rf.65312eb63a5812f622352f5ce42022e1.jpg,130,367,47710,32801,14909
/media/gufran/GsHDD/Work/Projects/AI/PotholeSeverityClassification/Data/Step1_data/OriginalDataset/533_png.rf.65312eb63a5812f622352f5ce42022e1.jpg,124,307,38068,30514,7554
/media/gufran/GsHDD/Work/Projects/AI/PotholeSeverityClassification/Data/Step1_data/OriginalDataset/535_png.rf.d2fc170a4b341a8e67a30dca12ffb90b.jpg,82,190,15580,9933,5647
/media/gufran/GsHDD/Work/Projects/AI/PotholeSeverityClassification/Data/Step1_data/OriginalDataset/536_png.rf.ac49e558db1d3d1ae45d1099b22aec6b.jpg,208,199,41392,28206,13186
/media/gufran/GsHDD/Work/Projects/AI/PotholeSeverityClassification/Data/Step1_data/OriginalDataset/537_png.rf.38b2e7d4d7e3cc71cd49cc5331d674fa.jpg,120,115,13800,10362,3438
/media/gufran/GsHDD/Work/Projects/AI/PotholeSeverityClassification/Data/Step1_data/OriginalDataset/538_png.rf.11c237bb4ee09ada23dc432f570443b6.jpg,133,232,30856,22905,7951
/media/gufran/GsHDD/Work/Projects/AI/PotholeSeverityClassification/Data/Step1_data/OriginalDataset/539_png.rf.8edf459f5037d111633aa7e1a110d5b7.jpg,114,193,22002,16807,5195
/media/gufran/GsHDD/Work/Projects/AI/PotholeSeverityClassification/Data/Step1_data/OriginalDataset/544_png.rf.9dd0a48bf4c4254d86b2349c38066823.jpg,100,322,32200,22057,10143
/media/gufran/GsHDD/Work/Projects/AI/PotholeSeverityClassification/Data/Step1_data/OriginalDataset/545_png.rf.e3a679ad47d27b6cd08d7a71561ddaa0.jpg,112,415,46480,36264,10216
/media/gufran/GsHDD/Work/Projects/AI/PotholeSeverityClassification/Data/Step1_data/OriginalDataset/547_png.rf.76c0559b01dbe2dd1c6005f8a03be716.jpg,96,301,28896,16749,12147
/media/gufran/GsHDD/Work/Projects/AI/PotholeSeverityClassification/Data/Step1_data/OriginalDataset/552_png.rf.c2913e563b6f1647623dc2cb98deb30c.jpg,142,412,58504,36403,22101
/media/gufran/GsHDD/Work/Projects/AI/PotholeSeverityClassification/Data/Step1_data/OriginalDataset/553_png.rf.931a51195c96ce5e909f97f81f22bec0.jpg,73,130,9490,7364,2126
/media/gufran/GsHDD/Work/Projects/AI/PotholeSeverityClassification/Data/Step1_data/OriginalDataset/555_png.rf.a592ab1cee5a6d0b7ec85a95ca7d2dcf.jpg,73,166,12118,7781,4337
/media/gufran/GsHDD/Work/Projects/AI/PotholeSeverityClassification/Data/Step1_data/OriginalDataset/556_png.rf.e85c5c733df2ec8d2a179cbc6b08089c.jpg,70,313,21910,17110,4800
/media/gufran/GsHDD/Work/Projects/AI/PotholeSeverityClassification/Data/Step1_data/OriginalDataset/557_png.rf.0201fe81dfff9efca2e859b719bc684c.jpg,70,268,18760,16174,2586
/media/gufran/GsHDD/Work/Projects/AI/PotholeSeverityClassification/Data/Step1_data/OriginalDataset/558_png.rf.96fa36b2afea4c714281609734e2050d.jpg,91,100,9100,7563,1537
/media/gufran/GsHDD/Work/Projects/AI/PotholeSeverityClassification/Data/Step1_data/OriginalDataset/559_png.rf.b832e0a86e0550672993ebdf6d22dafd.jpg,61,213,12993,11711,1282
/media/gufran/GsHDD/Work/Projects/AI/PotholeSeverityClassification/Data/Step1_data/OriginalDataset/55_png.rf.f08820781c839b2372affdd3269b927d.jpg,133,124,16492,13738,2754
/media/gufran/GsHDD/Work/Projects/AI/PotholeSeverityClassification/Data/Step1_data/OriginalDataset/560_png.rf.42a5af9bf7619e83a5a0a3f6399d64a5.jpg,65,162,10530,9200,1330
/media/gufran/GsHDD/Work/Projects/AI/PotholeSeverityClassification/Data/Step1_data/OriginalDataset/562_png.rf.f1d7614a9f66f00e561d07ec3616f090.jpg,57,250,14250,10939,3311
/media/gufran/GsHDD/Work/Projects/AI/PotholeSeverityClassification/Data/Step1_data/OriginalDataset/562_png.rf.f1d7614a9f66f00e561d07ec3616f090.jpg,59,43,2537,2019,518
/media/gufran/GsHDD/Work/Projects/AI/PotholeSeverityClassification/Data/Step1_data/OriginalDataset/564_png.rf.4d748a1fec312a2e660f6e8626abbe51.jpg,66,274,18084,15392,2692
/media/gufran/GsHDD/Work/Projects/AI/PotholeSeverityClassification/Data/Step1_data/OriginalDataset/570_png.rf.7017bf87bbb4166fb89e6d5307c65e5d.jpg,100,331,33100,27797,5303
/media/gufran/GsHDD/Work/Projects/AI/PotholeSeverityClassification/Data/Step1_data/OriginalDataset/571_png.rf.43d96eebcd92453815d05c433298818b.jpg,109,340,37060,30520,6540
/media/gufran/GsHDD/Work/Projects/AI/PotholeSeverityClassification/Data/Step1_data/OriginalDataset/572_png.rf.1c96295f75c4db872e4663e07a216469.jpg,113,358,40454,33208,7246
/media/gufran/GsHDD/Work/Projects/AI/PotholeSeverityClassification/Data/Step1_data/OriginalDataset/573_png.rf.68415641c714a9393da47eee4368b68f.jpg,118,361,42598,35463,7135
/media/gufran/GsHDD/Work/Projects/AI/PotholeSeverityClassification/Data/Step1_data/OriginalDataset/579_png.rf.52cd2c84358a53ab064a212b0e8513f0.jpg,82,106,8692,6724,1968
/media/gufran/GsHDD/Work/Projects/AI/PotholeSeverityClassification/Data/Step1_data/OriginalDataset/590_png.rf.9fb1b1ae377b00f77eba6a3140fbb1d0.jpg,70,146,10220,7714,2506
/media/gufran/GsHDD/Work/Projects/AI/PotholeSeverityClassification/Data/Step1_data/OriginalDataset/590_png.rf.9fb1b1ae377b00f77eba6a3140fbb1d0.jpg,50,211,10550,7464,3086
/media/gufran/GsHDD/Work/Projects/AI/PotholeSeverityClassification/Data/Step1_data/OriginalDataset/611_png.rf.8854b4f7a3efae92ef2dbcd6a5882b39.jpg,49,100,4900,3954,946
/media/gufran/GsHDD/Work/Projects/AI/PotholeSeverityClassification/Data/Step1_data/OriginalDataset/611_png.rf.8854b4f7a3efae92ef2dbcd6a5882b39.jpg,58,184,10672,8468,2204
/media/gufran/GsHDD/Work/Projects/AI/PotholeSeverityClassification/Data/Step1_data/OriginalDataset/489_png.rf.c95a410173a09dd6335b9ec30e94fad2.jpg,94,295,27730,16474,11256
/media/gufran/GsHDD/Work/Projects/AI/PotholeSeverityClassification/Data/Step1_data/OriginalDataset/49_png.rf.efcf337e848c7fb9f4efcb674ce7ebf4.jpg,168,205,34440,25106,9334
/media/gufran/GsHDD/Work/Projects/AI/PotholeSeverityClassification/Data/Step1_data/OriginalDataset/49_png.rf.efcf337e848c7fb9f4efcb674ce7ebf4.jpg,115,202,23230,14771,8459
/media/gufran/GsHDD/Work/Projects/AI/PotholeSeverityClassification/Data/Step1_data/OriginalDataset/49_png.rf.efcf337e848c7fb9f4efcb674ce7ebf4.jpg,84,175,14700,10296,4404
/media/gufran/GsHDD/Work/Projects/AI/PotholeSeverityClassification/Data/Step1_data/OriginalDataset/522_png.rf.ac65f2a5b6870b04664b80cdb8fd7d1e.jpg,65,322,20930,14709,6221
/media/gufran/GsHDD/Work/Projects/AI/PotholeSeverityClassification/Data/Step1_data/OriginalDataset/550_png.rf.0c189391e6559c2265f4bda1c006ab5b.jpg,203,310,62930,49063,13867
/media/gufran/GsHDD/Work/Projects/AI/PotholeSeverityClassification/Data/Step1_data/OriginalDataset/550_png.rf.0c189391e6559c2265f4bda1c006ab5b.jpg,62,85,5270,4059,1211
/media/gufran/GsHDD/Work/Projects/AI/PotholeSeverityClassification/Data/Step1_data/OriginalDataset/561_png.rf.5b7d0d309ce84aa153f7c1f29b96cd53.jpg,73,105,7665,6198,1467
/media/gufran/GsHDD/Work/Projects/AI/PotholeSeverityClassification/Data/Step1_data/OriginalDataset/561_png.rf.5b7d0d309ce84aa153f7c1f29b96cd53.jpg,49,244,11956,8824,3132
/media/gufran/GsHDD/Work/Projects/AI/PotholeSeverityClassification/Data/Step1_data/OriginalDataset/622_png.rf.33ffc8820217ee77e6d2dd29ff1add77.jpg,43,100,4300,3373,927
/media/gufran/GsHDD/Work/Projects/AI/PotholeSeverityClassification/Data/Step1_data/OriginalDataset/622_png.rf.33ffc8820217ee77e6d2dd29ff1add77.jpg,58,178,10324,8089,2235
/media/gufran/GsHDD/Work/Projects/AI/PotholeSeverityClassification/Data/Step1_data/OriginalDataset/627_png.rf.9365b46600404c421b8c6a001c083b84.jpg,55,359,19745,15395,4350
/media/gufran/GsHDD/Work/Projects/AI/PotholeSeverityClassification/Data/Step1_data/OriginalDataset/628_png.rf.d7cd95a9b657bcb9794a7689755c9d46.jpg,58,361,20938,16387,4551
/media/gufran/GsHDD/Work/Projects/AI/PotholeSeverityClassification/Data/Step1_data/OriginalDataset/629_png.rf.439b222643a1978c804ad38a759f73d0.jpg,64,364,23296,17651,5645
/media/gufran/GsHDD/Work/Projects/AI/PotholeSeverityClassification/Data/Step1_data/OriginalDataset/630_png.rf.0c5a22b7013b34ac90f1c7e8aa9eb01e.jpg,67,370,24790,18848,5942
/media/gufran/GsHDD/Work/Projects/AI/PotholeSeverityClassification/Data/Step1_data/OriginalDataset/631_png.rf.78a382259024c151c731e7f6ccda5e09.jpg,75,370,27750,19858,7892
/media/gufran/GsHDD/Work/Projects/AI/PotholeSeverityClassification/Data/Step1_data/OriginalDataset/632_png.rf.9a3270ea0dfbe145174babeba0d4dff7.jpg,82,370,30340,21073,9267
/media/gufran/GsHDD/Work/Projects/AI/PotholeSeverityClassification/Data/Step1_data/OriginalDataset/634_png.rf.94ef4f20981581e2a827736d7bbe601c.jpg,90,373,33570,24188,9382
/media/gufran/GsHDD/Work/Projects/AI/PotholeSeverityClassification/Data/Step1_data/OriginalDataset/635_png.rf.13aa5c4d70fb636b2a775e15b19640c3.jpg,93,367,34131,25518,8613
/media/gufran/GsHDD/Work/Projects/AI/PotholeSeverityClassification/Data/Step1_data/OriginalDataset/636_png.rf.aec6bb15c13e8752dc4c9d19fa99bc80.jpg,94,371,34874,26555,8319
/media/gufran/GsHDD/Work/Projects/AI/PotholeSeverityClassification/Data/Step1_data/OriginalDataset/638_png.rf.79dde02bb217976cea8656d83c2ffc0a.jpg,103,382,39346,29729,9617
/media/gufran/GsHDD/Work/Projects/AI/PotholeSeverityClassification/Data/Step1_data/OriginalDataset/639_png.rf.d245889c32ef10d51fb5cc1daad2e371.jpg,106,385,40810,30962,9848
/media/gufran/GsHDD/Work/Projects/AI/PotholeSeverityClassification/Data/Step1_data/OriginalDataset/640_png.rf.6c051a360a71ef91070730f8ef241562.jpg,109,385,41965,31509,10456
/media/gufran/GsHDD/Work/Projects/AI/PotholeSeverityClassification/Data/Step1_data/OriginalDataset/641_png.rf.2645a5f5defb9eeddc206a39ecbb9357.jpg,111,385,42735,32775,9960
/media/gufran/GsHDD/Work/Projects/AI/PotholeSeverityClassification/Data/Step1_data/OriginalDataset/642_png.rf.28f4bf4bc91a7becc0ebb19bf6214d58.jpg,114,397,45258,35281,9977
/media/gufran/GsHDD/Work/Projects/AI/PotholeSeverityClassification/Data/Step1_data/OriginalDataset/644_png.rf.00bcf1bc0f848c636cfd969f05af173b.jpg,117,397,46449,36009,10440
/media/gufran/GsHDD/Work/Projects/AI/PotholeSeverityClassification/Data/Step1_data/OriginalDataset/645_png.rf.ef2d05d62351c11a03b937bc40470636.jpg,123,404,49692,38172,11520
/media/gufran/GsHDD/Work/Projects/AI/PotholeSeverityClassification/Data/Step1_data/OriginalDataset/646_png.rf.e04602c2bc74e2674f72aab22cec539f.jpg,127,403,51181,38275,12906
/media/gufran/GsHDD/Work/Projects/AI/PotholeSeverityClassification/Data/Step1_data/OriginalDataset/647_png.rf.71b4077d83f3f3928bd51cdc0145d3fe.jpg,126,388,48888,38610,10278
/media/gufran/GsHDD/Work/Projects/AI/PotholeSeverityClassification/Data/Step1_data/OriginalDataset/648_png.rf.b53cc914e5ae7ff6281a3d334ba1eb7e.jpg,130,397,51610,39707,11903
/media/gufran/GsHDD/Work/Projects/AI/PotholeSeverityClassification/Data/Step1_data/OriginalDataset/650_png.rf.ecd214078648596e853c513d62e16e80.jpg,136,433,58888,45933,12955
/media/gufran/GsHDD/Work/Projects/AI/PotholeSeverityClassification/Data/Step1_data/OriginalDataset/651_png.rf.dfe99af73837491872165db74b142345.jpg,139,430,59770,46660,13110
/media/gufran/GsHDD/Work/Projects/AI/PotholeSeverityClassification/Data/Step1_data/OriginalDataset/652_png.rf.a3525a7f797d1776daaeb628661e669a.jpg,139,433,60187,47585,12602
/media/gufran/GsHDD/Work/Projects/AI/PotholeSeverityClassification/Data/Step1_data/OriginalDataset/653_png.rf.be5771e409c6688d26b631032942d2e1.jpg,136,415,56440,45201,11239
/media/gufran/GsHDD/Work/Projects/AI/PotholeSeverityClassification/Data/Step1_data/OriginalDataset/654_png.rf.66177976d7d092160faf44937911e0f1.jpg,142,409,58078,45579,12499
/media/gufran/GsHDD/Work/Projects/AI/PotholeSeverityClassification/Data/Step1_data/OriginalDataset/655_png.rf.fa32ea83ebe8222469a1331198ec9ecd.jpg,145,418,60610,47474,13136
/media/gufran/GsHDD/Work/Projects/AI/PotholeSeverityClassification/Data/Step1_data/OriginalDataset/656_png.rf.ec9a604f64263656f1698e01c5851b62.jpg,151,427,64477,49930,14547
/media/gufran/GsHDD/Work/Projects/AI/PotholeSeverityClassification/Data/Step1_data/OriginalDataset/657_png.rf.9306918e50a71f5ce4d956d58679f31c.jpg,155,430,66650,51746,14904
/media/gufran/GsHDD/Work/Projects/AI/PotholeSeverityClassification/Data/Step1_data/OriginalDataset/658_png.rf.ec9b1490e36702bfeeac73885630a606.jpg,157,430,67510,52776,14734
/media/gufran/GsHDD/Work/Projects/AI/PotholeSeverityClassification/Data/Step1_data/OriginalDataset/659_png.rf.374737014a76f60415ef21d2b032657e.jpg,160,436,69760,54213,15547
/media/gufran/GsHDD/Work/Projects/AI/PotholeSeverityClassification/Data/Step1_data/OriginalDataset/65_png.rf.ee6c208041e62c59db13ad883c261d68.jpg,139,133,18487,15543,2944
/media/gufran/GsHDD/Work/Projects/AI/PotholeSeverityClassification/Data/Step1_data/OriginalDataset/661_png.rf.4a59736d3ab505d7e0f28437079f5a73.jpg,163,445,72535,55751,16784
/media/gufran/GsHDD/Work/Projects/AI/PotholeSeverityClassification/Data/Step1_data/OriginalDataset/662_png.rf.b6575bd40c5c6c99242ca5693babf18c.jpg,169,460,77740,58570,19170
/media/gufran/GsHDD/Work/Projects/AI/PotholeSeverityClassification/Data/Step1_data/OriginalDataset/663_png.rf.411a59636978b7268bd9b3b96272ac8d.jpg,172,445,76540,58679,17861
/media/gufran/GsHDD/Work/Projects/AI/PotholeSeverityClassification/Data/Step1_data/OriginalDataset/665_png.rf.e376ecf2687eef81b4cb0babd3c63e21.jpg,175,466,81550,62098,19452
/media/gufran/GsHDD/Work/Projects/AI/PotholeSeverityClassification/Data/Step1_data/OriginalDataset/666_png.rf.37c0953567d6519f5f3f30d4ffd091aa.jpg,181,472,85432,63708,21724
/media/gufran/GsHDD/Work/Projects/AI/PotholeSeverityClassification/Data/Step1_data/OriginalDataset/667_png.rf.696033e229187845976bf17e45bf5898.jpg,178,457,81346,64384,16962
/media/gufran/GsHDD/Work/Projects/AI/PotholeSeverityClassification/Data/Step1_data/OriginalDataset/668_png.rf.fd54da4d8104a625d4d9e2c9a813fb7d.jpg,182,484,88088,68521,19567
/media/gufran/GsHDD/Work/Projects/AI/PotholeSeverityClassification/Data/Step1_data/OriginalDataset/669_png.rf.2d134d3c53d21fd5484f102e4691059d.jpg,182,475,86450,67206,19244
/media/gufran/GsHDD/Work/Projects/AI/PotholeSeverityClassification/Data/Step1_data/OriginalDataset/670_png.rf.c65dfb6a9db72e1a01915374d7efc6aa.jpg,184,502,92368,73102,19266
/media/gufran/GsHDD/Work/Projects/AI/PotholeSeverityClassification/Data/Step1_data/OriginalDataset/671_png.rf.53f729d301ef0ef3ae8c2fc2e9a71df7.jpg,188,499,93812,74120,19692
/media/gufran/GsHDD/Work/Projects/AI/PotholeSeverityClassification/Data/Step1_data/OriginalDataset/673_png.rf.babc57530f68962c5bd2820652bb5ef9.jpg,181,517,93577,75767,17810
/media/gufran/GsHDD/Work/Projects/AI/PotholeSeverityClassification/Data/Step1_data/OriginalDataset/675_png.rf.c76fe2930674dc66017920154dc94b11.jpg,172,478,82216,67269,14947
/media/gufran/GsHDD/Work/Projects/AI/PotholeSeverityClassification/Data/Step1_data/OriginalDataset/676_png.rf.07843563261f0c9bdae5b3a0bf12c3e9.jpg,169,490,82810,67426,15384
/media/gufran/GsHDD/Work/Projects/AI/PotholeSeverityClassification/Data/Step1_data/OriginalDataset/677_png.rf.9c9a4f6aee840e01411235b207ce4181.jpg,169,496,83824,64926,18898
/media/gufran/GsHDD/Work/Projects/AI/PotholeSeverityClassification/Data/Step1_data/OriginalDataset/678_png.rf.8643ce7527c3d2e9a983e7df4d136a34.jpg,157,445,69865,49069,20796
/media/gufran/GsHDD/Work/Projects/AI/PotholeSeverityClassification/Data/Step1_data/OriginalDataset/679_png.rf.dd191167b7121e7078e1bb74af6f3ba6.jpg,145,448,64960,43398,21562
/media/gufran/GsHDD/Work/Projects/AI/PotholeSeverityClassification/Data/Step1_data/OriginalDataset/680_png.rf.08887ae3fd5a1189e3eea716317ee215.jpg,128,466,59648,40084,19564
/media/gufran/GsHDD/Work/Projects/AI/PotholeSeverityClassification/Data/Step1_data/OriginalDataset/681_png.rf.417f8b999cadd4a1790e2298084e820d.jpg,116,448,51968,38022,13946
/media/gufran/GsHDD/Work/Projects/AI/PotholeSeverityClassification/Data/Step1_data/OriginalDataset/682_png.rf.b422dc784799d01fcff0d8f1f3dbccea.jpg,118,445,52510,37998,14512
/media/gufran/GsHDD/Work/Projects/AI/PotholeSeverityClassification/Data/Step1_data/OriginalDataset/683_png.rf.dc74c9041437b957ef7dcb9ab192de67.jpg,121,460,55660,39851,15809
/media/gufran/GsHDD/Work/Projects/AI/PotholeSeverityClassification/Data/Step1_data/OriginalDataset/686_png.rf.67a02c70600c046b65eb8342f58b9fa7.jpg,118,466,54988,41072,13916
/media/gufran/GsHDD/Work/Projects/AI/PotholeSeverityClassification/Data/Step1_data/OriginalDataset/687_png.rf.d6e33585b85a06223e479d7f5cf52118.jpg,112,496,55552,41359,14193
/media/gufran/GsHDD/Work/Projects/AI/PotholeSeverityClassification/Data/Step1_data/OriginalDataset/688_png.rf.a6d378ee3478adf5a720875f62509d1d.jpg,109,526,57334,42926,14408
/media/gufran/GsHDD/Work/Projects/AI/PotholeSeverityClassification/Data/Step1_data/OriginalDataset/697_png.rf.f285d8b8815f04681c821912c1984185.jpg,79,253,19987,14807,5180
/media/gufran/GsHDD/Work/Projects/AI/PotholeSeverityClassification/Data/Step1_data/OriginalDataset/697_png.rf.f285d8b8815f04681c821912c1984185.jpg,76,205,15580,13107,2473
/media/gufran/GsHDD/Work/Projects/AI/PotholeSeverityClassification/Data/Step1_data/OriginalDataset/698_png.rf.7371c79ade9e4e8fec9d91802279ae0d.jpg,82,208,17056,13846,3210
/media/gufran/GsHDD/Work/Projects/AI/PotholeSeverityClassification/Data/Step1_data/OriginalDataset/698_png.rf.7371c79ade9e4e8fec9d91802279ae0d.jpg,83,262,21746,16169,5577
/media/gufran/GsHDD/Work/Projects/AI/PotholeSeverityClassification/Data/Step1_data/OriginalDataset/699_png.rf.0e904a1cda17cd18e2d96c4c1d32d70b.jpg,85,217,18445,15350,3095
/media/gufran/GsHDD/Work/Projects/AI/PotholeSeverityClassification/Data/Step1_data/OriginalDataset/699_png.rf.0e904a1cda17cd18e2d96c4c1d32d70b.jpg,85,268,22780,16502,6278
/media/gufran/GsHDD/Work/Projects/AI/PotholeSeverityClassification/Data/Step1_data/OriginalDataset/700_png.rf.325740b432c6beabea26c9fcb3723127.jpg,89,274,24386,17375,7011
/media/gufran/GsHDD/Work/Projects/AI/PotholeSeverityClassification/Data/Step1_data/OriginalDataset/700_png.rf.325740b432c6beabea26c9fcb3723127.jpg,85,214,18190,15188,3002
/media/gufran/GsHDD/Work/Projects/AI/PotholeSeverityClassification/Data/Step1_data/OriginalDataset/701_png.rf.2d98b1210263d294528b64e4f0e3921c.jpg,100,274,27400,18985,8415
/media/gufran/GsHDD/Work/Projects/AI/PotholeSeverityClassification/Data/Step1_data/OriginalDataset/701_png.rf.2d98b1210263d294528b64e4f0e3921c.jpg,88,223,19624,16162,3462
/media/gufran/GsHDD/Work/Projects/AI/PotholeSeverityClassification/Data/Step1_data/OriginalDataset/702_png.rf.fcaaf3a146e75e0dc67f754440fa7f2c.jpg,100,271,27100,19102,7998
/media/gufran/GsHDD/Work/Projects/AI/PotholeSeverityClassification/Data/Step1_data/OriginalDataset/702_png.rf.fcaaf3a146e75e0dc67f754440fa7f2c.jpg,94,229,21526,17582,3944
/media/gufran/GsHDD/Work/Projects/AI/PotholeSeverityClassification/Data/Step1_data/OriginalDataset/703_png.rf.997af7fd89e3cb322fd24784a5c5044d.jpg,106,280,29680,20533,9147
/media/gufran/GsHDD/Work/Projects/AI/PotholeSeverityClassification/Data/Step1_data/OriginalDataset/703_png.rf.997af7fd89e3cb322fd24784a5c5044d.jpg,97,229,22213,18421,3792
/media/gufran/GsHDD/Work/Projects/AI/PotholeSeverityClassification/Data/Step1_data/OriginalDataset/704_png.rf.154469399d40fceb1bec17ed9c86e488.jpg,103,235,24205,19069,5136
/media/gufran/GsHDD/Work/Projects/AI/PotholeSeverityClassification/Data/Step1_data/OriginalDataset/704_png.rf.154469399d40fceb1bec17ed9c86e488.jpg,109,299,32591,22820,9771
/media/gufran/GsHDD/Work/Projects/AI/PotholeSeverityClassification/Data/Step1_data/OriginalDataset/705_png.rf.4a199019c150c9dc9b94c228e5cc0320.jpg,115,295,33925,23362,10563
/media/gufran/GsHDD/Work/Projects/AI/PotholeSeverityClassification/Data/Step1_data/OriginalDataset/705_png.rf.4a199019c150c9dc9b94c228e5cc0320.jpg,112,247,27664,21433,6231
/media/gufran/GsHDD/Work/Projects/AI/PotholeSeverityClassification/Data/Step1_data/OriginalDataset/706_png.rf.705cf4c64a9c780248e153352db7ec97.jpg,121,301,36421,25432,10989
/media/gufran/GsHDD/Work/Projects/AI/PotholeSeverityClassification/Data/Step1_data/OriginalDataset/706_png.rf.705cf4c64a9c780248e153352db7ec97.jpg,109,250,27250,21752,5498
/media/gufran/GsHDD/Work/Projects/AI/PotholeSeverityClassification/Data/Step1_data/OriginalDataset/709_png.rf.108c4b49f493143bfe7ee7d913c996ea.jpg,121,307,37147,26411,10736
/media/gufran/GsHDD/Work/Projects/AI/PotholeSeverityClassification/Data/Step1_data/OriginalDataset/709_png.rf.108c4b49f493143bfe7ee7d913c996ea.jpg,115,247,28405,22597,5808
/media/gufran/GsHDD/Work/Projects/AI/PotholeSeverityClassification/Data/Step1_data/OriginalDataset/710_png.rf.7f9cf85968bdcff59f8586673077a202.jpg,127,313,39751,27184,12567
/media/gufran/GsHDD/Work/Projects/AI/PotholeSeverityClassification/Data/Step1_data/OriginalDataset/710_png.rf.7f9cf85968bdcff59f8586673077a202.jpg,121,256,30976,24345,6631
/media/gufran/GsHDD/Work/Projects/AI/PotholeSeverityClassification/Data/Step1_data/OriginalDataset/711_png.rf.491ab37103c7c19e197c831a3039c88e.jpg,130,331,43030,29561,13469
/media/gufran/GsHDD/Work/Projects/AI/PotholeSeverityClassification/Data/Step1_data/OriginalDataset/711_png.rf.491ab37103c7c19e197c831a3039c88e.jpg,130,271,35230,27029,8201
/media/gufran/GsHDD/Work/Projects/AI/PotholeSeverityClassification/Data/Step1_data/OriginalDataset/712_png.rf.e4972ee11e92393c430f53b1becb9d1b.jpg,136,271,36856,28358,8498
/media/gufran/GsHDD/Work/Projects/AI/PotholeSeverityClassification/Data/Step1_data/OriginalDataset/712_png.rf.e4972ee11e92393c430f53b1becb9d1b.jpg,130,334,43420,30224,13196
/media/gufran/GsHDD/Work/Projects/AI/PotholeSeverityClassification/Data/Step1_data/OriginalDataset/713_png.rf.eab19d37d70f465e570b3e8a220cfc98.jpg,133,337,44821,31273,13548
/media/gufran/GsHDD/Work/Projects/AI/PotholeSeverityClassification/Data/Step1_data/OriginalDataset/713_png.rf.eab19d37d70f465e570b3e8a220cfc98.jpg,136,271,36856,28377,8479
/media/gufran/GsHDD/Work/Projects/AI/PotholeSeverityClassification/Data/Step1_data/OriginalDataset/714_png.rf.a1038c73542246245aca0af1800ae03b.jpg,136,349,47464,34013,13451
/media/gufran/GsHDD/Work/Projects/AI/PotholeSeverityClassification/Data/Step1_data/OriginalDataset/714_png.rf.a1038c73542246245aca0af1800ae03b.jpg,139,280,38920,29802,9118
/media/gufran/GsHDD/Work/Projects/AI/PotholeSeverityClassification/Data/Step1_data/OriginalDataset/715_png.rf.ee7e1c81a2de0b4ccadd65574715c9fc.jpg,133,349,46417,32919,13498
/media/gufran/GsHDD/Work/Projects/AI/PotholeSeverityClassification/Data/Step1_data/OriginalDataset/715_png.rf.ee7e1c81a2de0b4ccadd65574715c9fc.jpg,131,292,38252,30251,8001
/media/gufran/GsHDD/Work/Projects/AI/PotholeSeverityClassification/Data/Step1_data/OriginalDataset/716_png.rf.fe031861d452c91e86d20465dd9d2d8f.jpg,115,356,40940,28348,12592
/media/gufran/GsHDD/Work/Projects/AI/PotholeSeverityClassification/Data/Step1_data/OriginalDataset/716_png.rf.fe031861d452c91e86d20465dd9d2d8f.jpg,121,310,37510,28255,9255
/media/gufran/GsHDD/Work/Projects/AI/PotholeSeverityClassification/Data/Step1_data/OriginalDataset/717_png.rf.bb1ce9b21ea21d5850fb96a176a85991.jpg,112,352,39424,25623,13801
/media/gufran/GsHDD/Work/Projects/AI/PotholeSeverityClassification/Data/Step1_data/OriginalDataset/717_png.rf.bb1ce9b21ea21d5850fb96a176a85991.jpg,115,322,37030,27544,9486
/media/gufran/GsHDD/Work/Projects/AI/PotholeSeverityClassification/Data/Step1_data/OriginalDataset/719_png.rf.9d61f27b2c87eb7176664c210af762cd.jpg,94,331,31114,21935,9179
/media/gufran/GsHDD/Work/Projects/AI/PotholeSeverityClassification/Data/Step1_data/OriginalDataset/719_png.rf.9d61f27b2c87eb7176664c210af762cd.jpg,100,295,29500,22987,6513
/media/gufran/GsHDD/Work/Projects/AI/PotholeSeverityClassification/Data/Step1_data/OriginalDataset/721_png.rf.4760514a0dcb084ec2bbca80b794e4a0.jpg,71,310,22010,14329,7681
/media/gufran/GsHDD/Work/Projects/AI/PotholeSeverityClassification/Data/Step1_data/OriginalDataset/722_png.rf.9a76cea1f16630b5bd6af5df88ca3fb1.jpg,59,250,14750,10146,4604
/media/gufran/GsHDD/Work/Projects/AI/PotholeSeverityClassification/Data/Step1_data/OriginalDataset/722_png.rf.9a76cea1f16630b5bd6af5df88ca3fb1.jpg,64,301,19264,14003,5261
/media/gufran/GsHDD/Work/Projects/AI/PotholeSeverityClassification/Data/Step1_data/OriginalDataset/723_png.rf.750838d6df6208d749779a0b1f78ac3e.jpg,49,196,9604,7178,2426
/media/gufran/GsHDD/Work/Projects/AI/PotholeSeverityClassification/Data/Step1_data/OriginalDataset/723_png.rf.750838d6df6208d749779a0b1f78ac3e.jpg,52,208,10816,7841,2975
/media/gufran/GsHDD/Work/Projects/AI/PotholeSeverityClassification/Data/Step1_data/OriginalDataset/637_png.rf.8cad9d8181f2260f466c2b1ff8b2cd34.jpg,99,382,37818,28606,9212
/media/gufran/GsHDD/Work/Projects/AI/PotholeSeverityClassification/Data/Step1_data/OriginalDataset/649_png.rf.2da9a3303376fdf605bf93e0c8e8e537.jpg,133,421,55993,43813,12180
/media/gufran/GsHDD/Work/Projects/AI/PotholeSeverityClassification/Data/Step1_data/OriginalDataset/660_png.rf.d6fbbcde086c4c4fa09738cd44150cd0.jpg,163,448,73024,56348,16676
/media/gufran/GsHDD/Work/Projects/AI/PotholeSeverityClassification/Data/Step1_data/OriginalDataset/672_png.rf.134ae9fda4faa23ddde6ba8d58110446.jpg,181,493,89233,71216,18017
/media/gufran/GsHDD/Work/Projects/AI/PotholeSeverityClassification/Data/Step1_data/OriginalDataset/684_png.rf.64f8e382beba2a3c6af92f6e8c6de7f9.jpg,119,463,55097,40377,14720
/media/gufran/GsHDD/Work/Projects/AI/PotholeSeverityClassification/Data/Step1_data/OriginalDataset/720_png.rf.70dae0c3861b9746f6557ae87d2273d8.jpg,82,314,25748,17594,8154
/media/gufran/GsHDD/Work/Projects/AI/PotholeSeverityClassification/Data/Step1_data/OriginalDataset/720_png.rf.70dae0c3861b9746f6557ae87d2273d8.jpg,85,277,23545,19277,4268
/media/gufran/GsHDD/Work/Projects/AI/PotholeSeverityClassification/Data/Step1_data/OriginalDataset/754_png.rf.58184de5eb34247f3e01b87e90be90a2.jpg,58,146,8468,5979,2489
/media/gufran/GsHDD/Work/Projects/AI/PotholeSeverityClassification/Data/Step1_data/OriginalDataset/755_png.rf.e7f81183e899e66ace984a33e9be6282.jpg,73,157,11461,7965,3496
/media/gufran/GsHDD/Work/Projects/AI/PotholeSeverityClassification/Data/Step1_data/OriginalDataset/756_png.rf.1f75e5607d03e789e016e7b33c82031e.jpg,109,205,22345,14228,8117
/media/gufran/GsHDD/Work/Projects/AI/PotholeSeverityClassification/Data/Step1_data/OriginalDataset/757_png.rf.45218c1df67f45399d4e3e2dc6d8b610.jpg,160,232,37120,21633,15487
/media/gufran/GsHDD/Work/Projects/AI/PotholeSeverityClassification/Data/Step1_data/OriginalDataset/758_png.rf.b69d47a8dd98fa24cd98b2c8a503ee3a.jpg,145,247,35815,23072,12743
/media/gufran/GsHDD/Work/Projects/AI/PotholeSeverityClassification/Data/Step1_data/OriginalDataset/759_png.rf.392a22b294e7cddf9e660dc2687e5f88.jpg,118,212,25016,15803,9213
/media/gufran/GsHDD/Work/Projects/AI/PotholeSeverityClassification/Data/Step1_data/OriginalDataset/75_png.rf.d6d3aaec0b92fe7c2518ef0adf6dedae.jpg,130,362,47060,38977,8083
/media/gufran/GsHDD/Work/Projects/AI/PotholeSeverityClassification/Data/Step1_data/OriginalDataset/766_png.rf.2eb423f2dadeda8e3ea8f235f6ee524c.jpg,241,232,55912,37310,18602
/media/gufran/GsHDD/Work/Projects/AI/PotholeSeverityClassification/Data/Step1_data/OriginalDataset/767_png.rf.2bf27889b159eaf130f11546c9d0aa97.jpg,238,229,54502,35908,18594
/media/gufran/GsHDD/Work/Projects/AI/PotholeSeverityClassification/Data/Step1_data/OriginalDataset/768_png.rf.f1c7187d96c8bbcaf30c9f101fdcfc16.jpg,226,232,52432,35387,17045
/media/gufran/GsHDD/Work/Projects/AI/PotholeSeverityClassification/Data/Step1_data/OriginalDataset/769_png.rf.9634d679dc000f6288039dc52d3f45dd.jpg,226,232,52432,36275,16157
/media/gufran/GsHDD/Work/Projects/AI/PotholeSeverityClassification/Data/Step1_data/OriginalDataset/76_png.rf.c4daa0ba5b91570b203519dfd4490e6c.jpg,109,148,16132,13871,2261
/media/gufran/GsHDD/Work/Projects/AI/PotholeSeverityClassification/Data/Step1_data/OriginalDataset/770_png.rf.e386f2d0eae528d434a88362bd5682ce.jpg,226,223,50398,34050,16348
/media/gufran/GsHDD/Work/Projects/AI/PotholeSeverityClassification/Data/Step1_data/OriginalDataset/773_png.rf.aff6ec2e52b302bb68e36310f4821581.jpg,217,214,46438,31113,15325
/media/gufran/GsHDD/Work/Projects/AI/PotholeSeverityClassification/Data/Step1_data/OriginalDataset/774_png.rf.3f9a650bbee06133cdfc36ba0bb111b0.jpg,217,208,45136,30578,14558
/media/gufran/GsHDD/Work/Projects/AI/PotholeSeverityClassification/Data/Step1_data/OriginalDataset/775_png.rf.ae938ecab85ad9906ff3774247f51b05.jpg,220,208,45760,29687,16073
/media/gufran/GsHDD/Work/Projects/AI/PotholeSeverityClassification/Data/Step1_data/OriginalDataset/776_png.rf.d81bbd1900a041bf8b165339e6c9b069.jpg,202,187,37774,25788,11986
/media/gufran/GsHDD/Work/Projects/AI/PotholeSeverityClassification/Data/Step1_data/OriginalDataset/777_png.rf.5582141d096232e5be4987b8cbca2d43.jpg,190,157,29830,20994,8836
/media/gufran/GsHDD/Work/Projects/AI/PotholeSeverityClassification/Data/Step1_data/OriginalDataset/778_png.rf.1e97cb78e24eea47cdea69a59edfec8d.jpg,178,145,25810,19004,6806
/media/gufran/GsHDD/Work/Projects/AI/PotholeSeverityClassification/Data/Step1_data/OriginalDataset/779_png.rf.150bc1ea928dcc46715119e6447b125e.jpg,184,148,27232,19990,7242
/media/gufran/GsHDD/Work/Projects/AI/PotholeSeverityClassification/Data/Step1_data/OriginalDataset/77_png.rf.088869f2bae0d0242437cbb58282e3b6.jpg,112,391,43792,34029,9763
/media/gufran/GsHDD/Work/Projects/AI/PotholeSeverityClassification/Data/Step1_data/OriginalDataset/780_png.rf.7504a17cc1c2b98973e1520eccbf322e.jpg,178,154,27412,19682,7730
/media/gufran/GsHDD/Work/Projects/AI/PotholeSeverityClassification/Data/Step1_data/OriginalDataset/782_png.rf.57714c817e3ba323fdf386ec90173a93.jpg,169,145,24505,17762,6743
/media/gufran/GsHDD/Work/Projects/AI/PotholeSeverityClassification/Data/Step1_data/OriginalDataset/784_png.rf.0e37fd1dd64172e66c2d90e6a699ec1c.jpg,171,154,26334,19185,7149
/media/gufran/GsHDD/Work/Projects/AI/PotholeSeverityClassification/Data/Step1_data/OriginalDataset/785_png.rf.2337f761914143964807fe744f5cb12c.jpg,166,145,24070,17902,6168
/media/gufran/GsHDD/Work/Projects/AI/PotholeSeverityClassification/Data/Step1_data/OriginalDataset/786_png.rf.f69d1d798bff4e36803e925a17f5fed6.jpg,159,142,22578,17145,5433
/media/gufran/GsHDD/Work/Projects/AI/PotholeSeverityClassification/Data/Step1_data/OriginalDataset/787_png.rf.f7f88baa5a8003bcccfe5049e1375cbf.jpg,153,124,18972,14341,4631
/media/gufran/GsHDD/Work/Projects/AI/PotholeSeverityClassification/Data/Step1_data/OriginalDataset/788_png.rf.393577e3a7850f047613134ba4f7f72a.jpg,144,121,17424,13622,3802
/media/gufran/GsHDD/Work/Projects/AI/PotholeSeverityClassification/Data/Step1_data/OriginalDataset/789_png.rf.eefaa9fa3b620cc33e31a2d620c7157e.jpg,144,133,19152,14604,4548
/media/gufran/GsHDD/Work/Projects/AI/PotholeSeverityClassification/Data/Step1_data/OriginalDataset/78_png.rf.50b1075a2acc5d13f2d270657cc422e4.jpg,94,364,34216,25743,8473
/media/gufran/GsHDD/Work/Projects/AI/PotholeSeverityClassification/Data/Step1_data/OriginalDataset/790_png.rf.24e3d55048a003ab8704ca0a701a1d84.jpg,144,145,20880,15375,5505
/media/gufran/GsHDD/Work/Projects/AI/PotholeSeverityClassification/Data/Step1_data/OriginalDataset/791_png.rf.19329d9814a87aff4dea89cd399b9958.jpg,138,133,18354,13218,5136
/media/gufran/GsHDD/Work/Projects/AI/PotholeSeverityClassification/Data/Step1_data/OriginalDataset/793_png.rf.740c1d3d7cd712871709fa56db839ebf.jpg,129,127,16383,12281,4102
/media/gufran/GsHDD/Work/Projects/AI/PotholeSeverityClassification/Data/Step1_data/OriginalDataset/795_png.rf.db5571397bc8534068a39e4a0256887a.jpg,120,124,14880,10721,4159
/media/gufran/GsHDD/Work/Projects/AI/PotholeSeverityClassification/Data/Step1_data/OriginalDataset/796_png.rf.17db1fbb534e7201b91e819586240e33.jpg,117,124,14508,10534,3974
/media/gufran/GsHDD/Work/Projects/AI/PotholeSeverityClassification/Data/Step1_data/OriginalDataset/797_png.rf.0dd1249d6eb75917bf2c572108ca8dcf.jpg,108,118,12744,9048,3696
/media/gufran/GsHDD/Work/Projects/AI/PotholeSeverityClassification/Data/Step1_data/OriginalDataset/798_png.rf.c9096a1685ab8552aca84f491a1529f3.jpg,102,118,12036,8152,3884
/media/gufran/GsHDD/Work/Projects/AI/PotholeSeverityClassification/Data/Step1_data/OriginalDataset/799_png.rf.01833f94eac41aa3fde39bf789612a4f.jpg,102,121,12342,8263,4079
/media/gufran/GsHDD/Work/Projects/AI/PotholeSeverityClassification/Data/Step1_data/OriginalDataset/800_png.rf.07372e2284ab6b3e39e396a7335b9bd6.jpg,99,118,11682,7704,3978
/media/gufran/GsHDD/Work/Projects/AI/PotholeSeverityClassification/Data/Step1_data/OriginalDataset/801_png.rf.bc360e9e320064ab82edd925ccc3926c.jpg,93,118,10974,7021,3953
/media/gufran/GsHDD/Work/Projects/AI/PotholeSeverityClassification/Data/Step1_data/OriginalDataset/803_png.rf.03992a9e6487b0aef530693f6cd17cca.jpg,107,263,28141,19984,8157
/media/gufran/GsHDD/Work/Projects/AI/PotholeSeverityClassification/Data/Step1_data/OriginalDataset/803_png.rf.03992a9e6487b0aef530693f6cd17cca.jpg,90,112,10080,6377,3703
/media/gufran/GsHDD/Work/Projects/AI/PotholeSeverityClassification/Data/Step1_data/OriginalDataset/804_png.rf.e1e231840436cc84f9927cd58c0e6bc7.jpg,112,263,29456,20472,8984
/media/gufran/GsHDD/Work/Projects/AI/PotholeSeverityClassification/Data/Step1_data/OriginalDataset/804_png.rf.e1e231840436cc84f9927cd58c0e6bc7.jpg,84,97,8148,5687,2461
/media/gufran/GsHDD/Work/Projects/AI/PotholeSeverityClassification/Data/Step1_data/OriginalDataset/806_png.rf.f2be498668dbe3f114a765a6eaa9fc06.jpg,127,262,33274,23305,9969
/media/gufran/GsHDD/Work/Projects/AI/PotholeSeverityClassification/Data/Step1_data/OriginalDataset/807_png.rf.6503913a1810685c55b2ad242fcb961f.jpg,130,262,34060,23957,10103
/media/gufran/GsHDD/Work/Projects/AI/PotholeSeverityClassification/Data/Step1_data/OriginalDataset/808_png.rf.311752f533e8c0852b4fee283864c2e0.jpg,130,256,33280,24736,8544
/media/gufran/GsHDD/Work/Projects/AI/PotholeSeverityClassification/Data/Step1_data/OriginalDataset/809_png.rf.aa30e09d7506e75808cbd233b1daf88a.jpg,139,247,34333,25806,8527
/media/gufran/GsHDD/Work/Projects/AI/PotholeSeverityClassification/Data/Step1_data/OriginalDataset/80_png.rf.6747b0f9f121fa1a5ad568a92169bb07.jpg,187,505,94435,73804,20631
/media/gufran/GsHDD/Work/Projects/AI/PotholeSeverityClassification/Data/Step1_data/OriginalDataset/810_png.rf.4833a432182ccfcaf09008ad9854622f.jpg,133,241,32053,25150,6903
/media/gufran/GsHDD/Work/Projects/AI/PotholeSeverityClassification/Data/Step1_data/OriginalDataset/811_png.rf.5552acea458fff9d177ad98bf1102b70.jpg,136,235,31960,25014,6946
/media/gufran/GsHDD/Work/Projects/AI/PotholeSeverityClassification/Data/Step1_data/OriginalDataset/812_png.rf.0b6e5da90610da42d40d8a3c26bb2a47.jpg,136,235,31960,24262,7698
/media/gufran/GsHDD/Work/Projects/AI/PotholeSeverityClassification/Data/Step1_data/OriginalDataset/815_png.rf.9025ded2c1d949491eb98b6c95165768.jpg,130,238,30940,23448,7492
/media/gufran/GsHDD/Work/Projects/AI/PotholeSeverityClassification/Data/Step1_data/OriginalDataset/816_png.rf.4169e551d2c99b472c803c51800a1519.jpg,130,223,28990,21983,7007
/media/gufran/GsHDD/Work/Projects/AI/PotholeSeverityClassification/Data/Step1_data/OriginalDataset/818_png.rf.31c66583ae6eb8efaf404df02f32933c.jpg,127,223,28321,21428,6893
/media/gufran/GsHDD/Work/Projects/AI/PotholeSeverityClassification/Data/Step1_data/OriginalDataset/819_png.rf.fc277c2d41daee412c22867b2d5a2ade.jpg,121,220,26620,20204,6416
/media/gufran/GsHDD/Work/Projects/AI/PotholeSeverityClassification/Data/Step1_data/OriginalDataset/81_png.rf.576539d8a30a114dca230cc2d15016d5.jpg,183,517,94611,74076,20535
/media/gufran/GsHDD/Work/Projects/AI/PotholeSeverityClassification/Data/Step1_data/OriginalDataset/820_png.rf.8dbd911333e731230162732f6e82ec27.jpg,118,217,25606,19642,5964
/media/gufran/GsHDD/Work/Projects/AI/PotholeSeverityClassification/Data/Step1_data/OriginalDataset/821_png.rf.b68ef1ad96394dd9972e5d64a2e9e385.jpg,112,217,24304,19297,5007
/media/gufran/GsHDD/Work/Projects/AI/PotholeSeverityClassification/Data/Step1_data/OriginalDataset/822_png.rf.c573370ebcab4e201651fde8cad0e806.jpg,112,214,23968,18860,5108
/media/gufran/GsHDD/Work/Projects/AI/PotholeSeverityClassification/Data/Step1_data/OriginalDataset/823_png.rf.ab0f6ef36385b70c93a2ac0984597d45.jpg,109,205,22345,17631,4714
/media/gufran/GsHDD/Work/Projects/AI/PotholeSeverityClassification/Data/Step1_data/OriginalDataset/825_png.rf.7be5455ca88b25293bdb0653929d3671.jpg,115,205,23575,18063,5512
/media/gufran/GsHDD/Work/Projects/AI/PotholeSeverityClassification/Data/Step1_data/OriginalDataset/826_png.rf.c05275bbd3c414dfd890b4005b819694.jpg,112,205,22960,17430,5530
/media/gufran/GsHDD/Work/Projects/AI/PotholeSeverityClassification/Data/Step1_data/OriginalDataset/827_png.rf.eabbf2b123229c05ddd7f57d3a1e9aa6.jpg,112,202,22624,16701,5923
/media/gufran/GsHDD/Work/Projects/AI/PotholeSeverityClassification/Data/Step1_data/OriginalDataset/829_png.rf.15145666f1d3ffa360bea179df6240ae.jpg,103,199,20497,16028,4469
/media/gufran/GsHDD/Work/Projects/AI/PotholeSeverityClassification/Data/Step1_data/OriginalDataset/830_png.rf.96299b25f4fe061c0192368955f262d3.jpg,109,199,21691,16773,4918
/media/gufran/GsHDD/Work/Projects/AI/PotholeSeverityClassification/Data/Step1_data/OriginalDataset/831_png.rf.24a743d4d6f4ef0482ecf7793828be1d.jpg,115,196,22540,17679,4861
/media/gufran/GsHDD/Work/Projects/AI/PotholeSeverityClassification/Data/Step1_data/OriginalDataset/832_png.rf.ef5ab7ed7b82ade65209b3f700530eae.jpg,115,190,21850,16609,5241
/media/gufran/GsHDD/Work/Projects/AI/PotholeSeverityClassification/Data/Step1_data/OriginalDataset/833_png.rf.72a0eacd3ce7c0df5486932c05318291.jpg,120,190,22800,17135,5665
/media/gufran/GsHDD/Work/Projects/AI/PotholeSeverityClassification/Data/Step1_data/OriginalDataset/834_png.rf.569f34c6810dfb06f1fb2f28405ccaef.jpg,114,193,22002,16485,5517
/media/gufran/GsHDD/Work/Projects/AI/PotholeSeverityClassification/Data/Step1_data/OriginalDataset/836_png.rf.a230311eb6e24201290dc89c99f5655e.jpg,108,187,20196,15739,4457
/media/gufran/GsHDD/Work/Projects/AI/PotholeSeverityClassification/Data/Step1_data/OriginalDataset/837_png.rf.d52f7531f7371a92ab1c941952ab2139.jpg,99,187,18513,14285,4228
/media/gufran/GsHDD/Work/Projects/AI/PotholeSeverityClassification/Data/Step1_data/OriginalDataset/838_png.rf.31be30025461174dec6bd1daccf88e93.jpg,96,187,17952,13683,4269
/media/gufran/GsHDD/Work/Projects/AI/PotholeSeverityClassification/Data/Step1_data/OriginalDataset/839_png.rf.bd839e179399cfec790c8f035d33e7e7.jpg,93,184,17112,13009,4103
/media/gufran/GsHDD/Work/Projects/AI/PotholeSeverityClassification/Data/Step1_data/OriginalDataset/840_png.rf.b8961f60ca30462a32a78417f017efef.jpg,84,181,15204,11991,3213
/media/gufran/GsHDD/Work/Projects/AI/PotholeSeverityClassification/Data/Step1_data/OriginalDataset/847_png.rf.06939c61002851f2c964c185c23b55d7.jpg,121,223,26983,20395,6588
/media/gufran/GsHDD/Work/Projects/AI/PotholeSeverityClassification/Data/Step1_data/OriginalDataset/848_png.rf.0d1bcee162f4c4f66b9f573216fc1971.jpg,124,226,28024,20975,7049
/media/gufran/GsHDD/Work/Projects/AI/PotholeSeverityClassification/Data/Step1_data/OriginalDataset/849_png.rf.b6987d033c58cccaaccc6796be5da255.jpg,109,235,25615,20993,4622
/media/gufran/GsHDD/Work/Projects/AI/PotholeSeverityClassification/Data/Step1_data/OriginalDataset/851_png.rf.d3b1bf46bf21aeaacc5beb5bc94db486.jpg,112,238,26656,21131,5525
/media/gufran/GsHDD/Work/Projects/AI/PotholeSeverityClassification/Data/Step1_data/OriginalDataset/852_png.rf.e1e75638a4e3b2447aea32055835e5e2.jpg,142,238,33796,25614,8182
/media/gufran/GsHDD/Work/Projects/AI/PotholeSeverityClassification/Data/Step1_data/OriginalDataset/855_png.rf.11b93f38f6903b2df9e659627459a62c.jpg,157,282,44274,34264,10010
/media/gufran/GsHDD/Work/Projects/AI/PotholeSeverityClassification/Data/Step1_data/OriginalDataset/890_png.rf.6aa0b6070f70bd066c1ee66a9a1ed989.jpg,113,322,36386,29327,7059
/media/gufran/GsHDD/Work/Projects/AI/PotholeSeverityClassification/Data/Step1_data/OriginalDataset/891_png.rf.1a02709bf60bc3a27c32977f8416a725.jpg,119,340,40460,32017,8443
/media/gufran/GsHDD/Work/Projects/AI/PotholeSeverityClassification/Data/Step1_data/OriginalDataset/892_png.rf.391d48d46360c5fb1126a7b843333407.jpg,131,346,45326,37293,8033
/media/gufran/GsHDD/Work/Projects/AI/PotholeSeverityClassification/Data/Step1_data/OriginalDataset/893_png.rf.dd5fdc4ddba08ef8a8ea400f00e3b9de.jpg,137,364,49868,40211,9657
/media/gufran/GsHDD/Work/Projects/AI/PotholeSeverityClassification/Data/Step1_data/OriginalDataset/894_png.rf.477393da4666ba51c3083212910a1f9e.jpg,142,382,54244,44207,10037
/media/gufran/GsHDD/Work/Projects/AI/PotholeSeverityClassification/Data/Step1_data/OriginalDataset/761_png.rf.5bf0e8401511e74d3fb4dba2aeb0a61d.jpg,67,154,10318,7189,3129
/media/gufran/GsHDD/Work/Projects/AI/PotholeSeverityClassification/Data/Step1_data/OriginalDataset/772_png.rf.2ed319b88f057c45bfbd433c18116643.jpg,223,220,49060,32025,17035
/media/gufran/GsHDD/Work/Projects/AI/PotholeSeverityClassification/Data/Step1_data/OriginalDataset/783_png.rf.bb1e6140e76a3974de7af684b55e90f5.jpg,166,148,24568,17508,7060
/media/gufran/GsHDD/Work/Projects/AI/PotholeSeverityClassification/Data/Step1_data/OriginalDataset/794_png.rf.ba981d671e73280e56cf3f3fb54e550a.jpg,123,124,15252,11287,3965
/media/gufran/GsHDD/Work/Projects/AI/PotholeSeverityClassification/Data/Step1_data/OriginalDataset/805_png.rf.12a5b06c8fa1a7ee3c0e073c7579e46a.jpg,116,266,30856,22347,8509
/media/gufran/GsHDD/Work/Projects/AI/PotholeSeverityClassification/Data/Step1_data/OriginalDataset/817_png.rf.e29c1590dd4347e42238aebae8e6085e.jpg,130,226,29380,21854,7526
/media/gufran/GsHDD/Work/Projects/AI/PotholeSeverityClassification/Data/Step1_data/OriginalDataset/828_png.rf.f1ee1cd018a803fdbe7574750e105c25.jpg,106,202,21412,16790,4622
/media/gufran/GsHDD/Work/Projects/AI/PotholeSeverityClassification/Data/Step1_data/OriginalDataset/83_png.rf.287298f3b1d6dfddae012cf3e7af717d.jpg,181,550,99550,71130,28420
/media/gufran/GsHDD/Work/Projects/AI/PotholeSeverityClassification/Data/Step1_data/OriginalDataset/850_png.rf.9bcab65dd2c8e8ddd180f58eab37777b.jpg,124,232,28768,21646,7122
/media/gufran/GsHDD/Work/Projects/AI/PotholeSeverityClassification/Data/Step1_data/OriginalDataset/923_png.rf.ad5676882e38c87286026e06d0d41f01.jpg,92,408,37536,25673,11863
/media/gufran/GsHDD/Work/Projects/AI/PotholeSeverityClassification/Data/Step1_data/OriginalDataset/934_png.rf.4e1cff40b1132c611edfa3ffa8084274.jpg,97,373,36181,27889,8292
/media/gufran/GsHDD/Work/Projects/AI/PotholeSeverityClassification/Data/Step1_data/OriginalDataset/978_png.rf.ec2124cca403d34d35656f10ced2527f.jpg,109,319,34771,20735,14036
/media/gufran/GsHDD/Work/Projects/AI/PotholeSeverityClassification/Data/Step1_data/OriginalDataset/989_png.rf.6156d72d324fe02b9848bb392fd87ee9.jpg,136,422,57392,36425,20967
/media/gufran/GsHDD/Work/Projects/AI/PotholeSeverityClassification/Data/Step1_data/OriginalDataset/914_png.rf.fea2b2bec7f381ff7df0c25817eeb00e.jpg,85,247,20995,16353,4642
/media/gufran/GsHDD/Work/Projects/AI/PotholeSeverityClassification/Data/Step1_data/OriginalDataset/915_png.rf.d6ef72d3c1f89e37abd09d79894de7bd.jpg,94,277,26038,19239,6799
/media/gufran/GsHDD/Work/Projects/AI/PotholeSeverityClassification/Data/Step1_data/OriginalDataset/916_png.rf.ccc6e860a887a5b7406fdc9315135804.jpg,103,292,30076,21095,8981
/media/gufran/GsHDD/Work/Projects/AI/PotholeSeverityClassification/Data/Step1_data/OriginalDataset/917_png.rf.b9e26f01335a0dc7167a7bfa991f173b.jpg,103,322,33166,24054,9112
/media/gufran/GsHDD/Work/Projects/AI/PotholeSeverityClassification/Data/Step1_data/OriginalDataset/918_png.rf.d79cb7c1888627ae1aec58f4911a14e0.jpg,112,361,40432,28504,11928
/media/gufran/GsHDD/Work/Projects/AI/PotholeSeverityClassification/Data/Step1_data/OriginalDataset/919_png.rf.ca004b100fa2ab56f7ad2cb4ecb9c051.jpg,133,385,51205,34946,16259
/media/gufran/GsHDD/Work/Projects/AI/PotholeSeverityClassification/Data/Step1_data/OriginalDataset/920_png.rf.4afd92b742fe38197732a286c825e0dd.jpg,145,200,29000,23649,5351
/media/gufran/GsHDD/Work/Projects/AI/PotholeSeverityClassification/Data/Step1_data/OriginalDataset/921_png.rf.ea2b0e76fa17eecf5aeb1ce1f346c7db.jpg,145,427,61915,46711,15204
/media/gufran/GsHDD/Work/Projects/AI/PotholeSeverityClassification/Data/Step1_data/OriginalDataset/922_png.rf.17fdf7c82202ba62574b48d392044af7.jpg,115,445,51175,37414,13761
/media/gufran/GsHDD/Work/Projects/AI/PotholeSeverityClassification/Data/Step1_data/OriginalDataset/92_png.rf.c72de3ff26f11aea77772abc76637150.jpg,107,422,45154,35496,9658
/media/gufran/GsHDD/Work/Projects/AI/PotholeSeverityClassification/Data/Step1_data/OriginalDataset/930_png.rf.eefc511e716cf34f749650a2e6eef20a.jpg,182,361,65702,53374,12328
/media/gufran/GsHDD/Work/Projects/AI/PotholeSeverityClassification/Data/Step1_data/OriginalDataset/931_png.rf.1eefb21fed3c28f3f417ebe3395e82b9.jpg,162,208,33696,27706,5990
/media/gufran/GsHDD/Work/Projects/AI/PotholeSeverityClassification/Data/Step1_data/OriginalDataset/932_png.rf.1cd95bb2272bf299195405f68d839409.jpg,85,334,28390,20853,7537
/media/gufran/GsHDD/Work/Projects/AI/PotholeSeverityClassification/Data/Step1_data/OriginalDataset/933_png.rf.33b8edb27699b4de29eea950db9faeef.jpg,83,340,28220,22861,5359
/media/gufran/GsHDD/Work/Projects/AI/PotholeSeverityClassification/Data/Step1_data/OriginalDataset/935_png.rf.e26bd040e210002356634a90547ce1a1.jpg,97,391,37927,29913,8014
/media/gufran/GsHDD/Work/Projects/AI/PotholeSeverityClassification/Data/Step1_data/OriginalDataset/936_png.rf.8f1b9e1c95f8f31f0b836df187b464cb.jpg,100,397,39700,30925,8775
/media/gufran/GsHDD/Work/Projects/AI/PotholeSeverityClassification/Data/Step1_data/OriginalDataset/937_png.rf.7518a29fa01dd1d3040990670562c02e.jpg,89,424,37736,24943,12793
/media/gufran/GsHDD/Work/Projects/AI/PotholeSeverityClassification/Data/Step1_data/OriginalDataset/941_png.rf.d6919e478dc8ec5cff003687aa87719c.jpg,180,214,38520,32841,5679
/media/gufran/GsHDD/Work/Projects/AI/PotholeSeverityClassification/Data/Step1_data/OriginalDataset/952_png.rf.439c546db142587dac709523e7c220d8.jpg,204,226,46104,38824,7280
/media/gufran/GsHDD/Work/Projects/AI/PotholeSeverityClassification/Data/Step1_data/OriginalDataset/962_png.rf.3a61c82c0061bb4fa6b91c746a4e936d.jpg,231,238,54978,45663,9315
/media/gufran/GsHDD/Work/Projects/AI/PotholeSeverityClassification/Data/Step1_data/OriginalDataset/972_png.rf.6d61357f99086283de2f216acb47725d.jpg,57,250,14250,8389,5861
/media/gufran/GsHDD/Work/Projects/AI/PotholeSeverityClassification/Data/Step1_data/OriginalDataset/973_png.rf.f03aa12deba0f18679a7cd210b530d2a.jpg,244,259,63196,51638,11558
/media/gufran/GsHDD/Work/Projects/AI/PotholeSeverityClassification/Data/Step1_data/OriginalDataset/974_png.rf.34b361846abfeb7eda17072ead43070f.jpg,60,265,15900,10396,5504
/media/gufran/GsHDD/Work/Projects/AI/PotholeSeverityClassification/Data/Step1_data/OriginalDataset/975_png.rf.06c4b1238f09f88da0bbb85a96f1501e.jpg,72,265,19080,12436,6644
/media/gufran/GsHDD/Work/Projects/AI/PotholeSeverityClassification/Data/Step1_data/OriginalDataset/976_png.rf.5f3c737299e05c063c58dbf3bef002c5.jpg,87,283,24621,14825,9796
/media/gufran/GsHDD/Work/Projects/AI/PotholeSeverityClassification/Data/Step1_data/OriginalDataset/977_png.rf.f7d4b88321e23b3fec5410e88fc15a93.jpg,106,307,32542,19150,13392
/media/gufran/GsHDD/Work/Projects/AI/PotholeSeverityClassification/Data/Step1_data/OriginalDataset/979_png.rf.0557fc0c6ac8df727031b0945c8923cb.jpg,109,328,35752,21727,14025
/media/gufran/GsHDD/Work/Projects/AI/PotholeSeverityClassification/Data/Step1_data/OriginalDataset/980_png.rf.a25811f985b4e8a8fe1a85963cbc8a8d.jpg,115,334,38410,23770,14640
/media/gufran/GsHDD/Work/Projects/AI/PotholeSeverityClassification/Data/Step1_data/OriginalDataset/981_png.rf.550e3dd861ab5d1e389a4ab5fe179ee5.jpg,124,343,42532,25177,17355
/media/gufran/GsHDD/Work/Projects/AI/PotholeSeverityClassification/Data/Step1_data/OriginalDataset/982_png.rf.60bec0b83f1e4fd262ecf322eec9b88c.jpg,130,355,46150,27287,18863
/media/gufran/GsHDD/Work/Projects/AI/PotholeSeverityClassification/Data/Step1_data/OriginalDataset/983_png.rf.51e2fc6912171f61513280715f1ebf8d.jpg,256,268,68608,56729,11879
/media/gufran/GsHDD/Work/Projects/AI/PotholeSeverityClassification/Data/Step1_data/OriginalDataset/984_png.rf.33fd96e7b93f9a2ea55815bfb4108587.jpg,139,364,50596,30039,20557
/media/gufran/GsHDD/Work/Projects/AI/PotholeSeverityClassification/Data/Step1_data/OriginalDataset/985_png.rf.3b512afc6a3f895b536028c49fd78144.jpg,145,380,55100,33737,21363
/media/gufran/GsHDD/Work/Projects/AI/PotholeSeverityClassification/Data/Step1_data/OriginalDataset/986_png.rf.d260ec937e8a83ee65fd27b53947211f.jpg,148,388,57424,35411,22013
/media/gufran/GsHDD/Work/Projects/AI/PotholeSeverityClassification/Data/Step1_data/OriginalDataset/987_png.rf.c4ebe367470a67c49ea42bd51d8c59ae.jpg,146,397,57962,36960,21002
/media/gufran/GsHDD/Work/Projects/AI/PotholeSeverityClassification/Data/Step1_data/OriginalDataset/988_png.rf.0c7001aaee383fb11192a2510b4b041c.jpg,142,415,58930,37778,21152
/media/gufran/GsHDD/Work/Projects/AI/PotholeSeverityClassification/Data/Step1_data/OriginalDataset/98_png.rf.263155cb5971321d371894f550d56af2.jpg,104,359,37336,27036,10300
/media/gufran/GsHDD/Work/Projects/AI/PotholeSeverityClassification/Data/Step1_data/OriginalDataset/990_png.rf.79decade44a90321e9344f180f30c8c1.jpg,124,410,50840,30357,20483
/media/gufran/GsHDD/Work/Projects/AI/PotholeSeverityClassification/Data/Step1_data/OriginalDataset/991_png.rf.c6ed5555c70dd8489cf1bceb3261997d.jpg,103,362,37286,21821,15465
/media/gufran/GsHDD/Work/Projects/AI/PotholeSeverityClassification/Data/Step1_data/OriginalDataset/992_png.rf.a2d98bfe1aa8f0b7e0208dddefdc715a.jpg,85,290,24650,15279,9371
/media/gufran/GsHDD/Work/Projects/AI/PotholeSeverityClassification/Data/Step1_data/OriginalDataset/993_png.rf.63f993a6a727b9988ffd04da0f7756e4.jpg,58,215,12470,8956,3514
/media/gufran/GsHDD/Work/Projects/AI/PotholeSeverityClassification/Data/Step1_data/OriginalDataset/994_png.rf.16a0d8c160fab2fdb903cb40e2a74e02.jpg,244,268,65392,55735,9657
/media/gufran/GsHDD/Work/Projects/AI/PotholeSeverityClassification/Data/Step1_data/OriginalDataset/99_png.rf.821862ce7048afdef3e74c7c559ad0f5.jpg,89,329,29281,19920,9361
